Knut Haanaes: Two reasons companies fail -- and how to avoid them
Lisa Nip: How humans could evolve to survive in space
Dan Gross: Why gun violence can't be our new normal
Angélica Dass: The beauty of human skin in every color
Alex Kipman: A futuristic vision of the age of holograms
Siyanda Mohutsiwa: How young Africans found a voice on Twitter
Latif Nasser: You have no idea where camels really come from
Carol Fishman Cohen: How to get back to work after a career break
Adam Foss: A prosecutor's vision for a better justice system
Meron Gribetz: A glimpse of the future through an augmented reality headset
Arthur Brooks: A conservative's plea: Let's work together
Jessica Ladd: The reporting system that sexual assault survivors want
Tim Urban: Inside the mind of a master procrastinator
Joe Gebbia: How Airbnb designs for trust
Casey Gerald: The gospel of doubt
Tshering Tobgay: This country isn't just carbon neutral -- it's carbon negative
Mileha Soneji: Simple hacks for life with Parkinson's
Laura Robinson: The secrets I find on the mysterious ocean floor
Caleb Harper: This computer will grow your food in the future
Reshma Saujani: Teach girls bravery, not perfection
Travis Kalanick: Uber's plan to get more people into fewer cars
Alexander Betts: Our refugee system is failing. Here's how we can fix it
Russ Altman: What really happens when you mix medications?
Magda Sayeg: How yarn bombing grew into a worldwide movement
Thomas Peschak: Dive into an ocean photographer's world
Ivan Coyote: Why we need gender-neutral bathrooms
Mary Bassett: Why your doctor should care about social justice
Audrey Choi: How to make a profit while making a difference
Dalia Mogahed: What do you think when you look at me?
Al Gore: The case for optimism on climate change
Raffaello D'Andrea: Meet the dazzling flying machines of the future
Allan Adams: What the discovery of gravitational waves means
Shonda Rhimes: My year of saying yes to everything
Celeste Headlee: 10 ways to have a better conversation
Jocelyne Bloch: The brain may be able to repair itself -- with help
Dorothy Roberts: The problem with race-based medicine
Mike Velings: The case for fish farming
Gregory Heyworth: How I'm discovering the secrets of ancient texts
Sean Follmer: Shape-shifting tech will change work as we know it
Dambisa Moyo: Economic growth has stalled. Let's fix it
Matthew Williams: Special Olympics let me be myself -- a champion
Pardis Sabeti: How we'll fight the next deadly virus
Judson Brewer: A simple way to break a bad habit
Andrés Ruzo: How I found a mythical boiling river in the Amazon
Linda Liukas: A delightful way to teach kids about computers
Melati and Isabel Wijsen: Our campaign to ban plastic bags in Bali
Auke Ijspeert: A robot that runs and swims like a salamander
Tania Simoncelli: Should you be able to patent a human gene?
David Gruber: Glow-in-the-dark sharks and other stunning sea creatures
Yanis Varoufakis: Capitalism will eat democracy -- unless we speak up
Elizabeth Lev: The unheard story of the Sistine Chapel
Achenyo Idachaba: How I turned a deadly plant into a thriving business
Oscar Schwartz: Can a computer write poetry?
Jill Farrant: How we can make crops survive without water
Jill Heinerth: The mysterious world of underwater caves
Ole Scheeren: Why great architecture should tell a story
Wael Ghonim: Let's design social media that drives real change
Melvin Russell: I love being a police officer, but we need reform
Tim Harford: How messy problems can inspire creativity
James Veitch: This is what happens when you reply to spam email
David Sedlak: 4 ways we can avoid a catastrophic drought
Aomawa Shields: How we'll find life on other planets
Sebastian Wernicke: How to use data to make a hit TV show
Harry Cliff: Have we reached the end of physics?
Robert Waldinger: What makes a good life? Lessons from the longest study on happiness
Jason deCaires Taylor: An underwater art museum, teeming with life
Rodrigo Bijou: Governments don't understand cyber warfare. We need hackers
António Guterres: Refugees have the right to be protected
Jane Fonda and Lily Tomlin: A hilarious celebration of lifelong female friendship
Alison Killing: What happens when a city runs out of room for its dead
Lucianne Walkowicz: Let's not use Mars as a backup planet
Paul Greenberg: The four fish we're overeating -- and what to eat instead
Nicole Paris and Ed Cage: A beatboxing lesson from a father-daughter duo
Raymond Wang: How germs travel on planes -- and how we can stop them
Danit Peleg: Forget shopping. Soon you'll download your new clothes
Jedidah Isler: The untapped genius that could change science for the better
Guillaume Néry: The exhilarating peace of freediving
Chieko Asakawa: How new technology helps blind people explore the world
Jessica Shortall: The US needs paid family leave -- for the sake of its future
Kristen Marhaver: How we're growing baby corals to rebuild reefs
Marina Abramović: An art made of trust, vulnerability and connection
Regina Hartley: Why the best hire might not have the perfect resume
Ann Morgan: My year reading a book from every country in the world
Genevieve von Petzinger: Why are these 32 symbols found in ancient caves all over Europe?
Carl Safina: What are animals thinking and feeling?
Anote Tong: My country will be underwater soon -- unless we work together
Nonny de la Peña: The future of news? Virtual reality
Josh Luber: The secret sneaker market -- and why it matters
Jean-Paul Mari: The chilling aftershock of a brush with death
Chelsea Shields: How I'm working for change inside my church
Andreas Ekström: The moral bias behind your search results
Jenni Chang and Lisa Dazols: This is what LGBT life is like around the world
Kaki King: A musical escape into a world of light and color
Harald Haas: Forget Wi-Fi. Meet the new Li-Fi Internet
Patrícia Medici: The coolest animal you know nothing about ... and how we can save it
Melissa Fleming: A boat carrying 500 refugees sunk at sea. The story of two survivors
Nancy Lublin: The heartbreaking text that inspired a crisis help line
Daniel Levitin: How to stay calm when you know you'll be stressed
Mathias Jud: Art that lets you talk back to NSA spies
Christine Sun Kim: The enchanting music of sign language
Cesar Harada: How I teach kids to love science
Hilary Cottam: Social services are broken. How we can fix them
Francesco Sauro: Deep under the Earth's surface, discovering beauty and science
Tom Uglow: An Internet without screens might look like this
Jennifer Doudna: We can now edit our DNA. But let's do it wisely
Will Potter: The secret US prisons you've never heard of before
Meklit Hadero: The unexpected beauty of everyday sounds
Anders Fjellberg: Two nameless bodies washed up on the beach. Here are their stories
Alyson McGregor: Why medicine often has dangerous side effects for women
Vijay Kumar: The future of flying robots
Michael Green: How we can make the world a better place by 2030
Teitur: Home is a song I've always remembered
Sandrine Thuret: You can grow new brain cells. Here's how
Neri Oxman: Design at the intersection of technology and biology
Siddhartha Mukherjee: Soon we'll cure diseases with a cell, not a pill
Alice Bows-Larkin: Climate change is happening. Here's how we adapt
Emilie Wapnick: Why some of us don't have one true calling
Martin Pistorius: How my mind came back to life — and no one knew
Mac Stone: Stunning photos of the endangered Everglades
Taiye Selasi: Don't ask where I'm from, ask where I'm a local
Samuel Cohen: Alzheimer's is not normal aging — and we can cure it
Robin Morgan: 4 powerful poems about Parkinson's and growing older
Mary Robinson: Why climate change is a threat to human rights
Frances Larson: Why public beheadings get millions of views
Sakena Yacoobi: How I stopped the Taliban from shutting down my school
Scott Dinsmore: How to find work you love
Mandy Len Catron: Falling in love is the easy part
Michael Kimmel: Why gender equality is good for everyone — men included
Mia Birdsong: The story we tell about poverty isn't true
David Rothkopf: How fear drives American politics
Billie Jean King: This tennis icon paved the way for women in sports
BJ Miller: What really matters at the end of life
Barry Schwartz: The way we think about work is broken
Alan Eustace: I leapt from the stratosphere. Here's how I did it
Jim Simons: A rare interview with the mathematician who cracked Wall Street
Jamie Bartlett: How the mysterious dark net is going mainstream
Elizabeth Nyamayaro: An invitation to men who want a better world for women
Wendy Freedman: This new telescope might show us the beginning of the universe
Yves Morieux: How too many rules at work keep you from getting things done
Robin Murphy: These robots come to the rescue after a disaster
Seth Berkley: The troubling reason why vaccines are made too late ... if they're made at all
Jim Al-Khalili: How quantum biology might explain life’s biggest questions
Dustin Yellin: A journey through the mind of an artist
Christopher Soghoian: How to avoid surveillance ... with the phone in your pocket
Tony Wyss-Coray: How young blood might help reverse aging. Yes, really
Manuel Lima: A visual history of human knowledge
Alix Generous: How I learned to communicate my inner life with Asperger's
Patience Mthunzi: Could we cure HIV with lasers?
Matt Kenyon: A secret memorial for civilian casualties
Rich Benjamin: My road trip through the whitest towns in America
Benedetta Berti: The surprising way groups like ISIS stay in power
Yuval Noah Harari: What explains the rise of humans?
eL Seed: Street art with a message of hope and peace
John Green: The nerd's guide to learning everything online
Alaa Murabit: What my religion really says about women
Jon Ronson: When online shaming spirals out of control
Marlene Zuk: What we learn from insects’ kinky sex lives
Salvatore Iaconesi: What happened when I open-sourced my brain cancer
Alec Soth + Stacey Baker: This is what enduring love looks like
Aspen Baker: A better way to talk about abortion
Noy Thrupkaew: Human trafficking is all around you. This is how it works
Ash Beckham: When to take a stand -- and when to let it go
Johann Hari: Everything you think you know about addiction is wrong
Memory Banda: A warrior’s cry against child marriage
Rajiv Maheswaran: The math behind basketball's wildest moves
Gayle Tzemach Lemmon: Meet the women fighting on the front lines of an American war
Latif Nasser: The amazing story of the man who gave us modern pain relief
Jimmy Carter: Why I believe the mistreatment of women is the number one human rights abuse 
Dame Ellen MacArthur: The surprising thing I learned sailing solo around the world
Chris Urmson: How a driverless car sees the road
Maryn McKenna: What do we do when antibiotics don’t work any more?
Chip Kidd: The art of first impressions -- in design and life
Roxane Gay: Confessions of a bad feminist
Joey Alexander: An 11-year-old prodigy performs old-school jazz
LaToya Ruby Frazier: A visual history of inequality in industrial America
Steve Silberman: The forgotten history of autism
Margaret Heffernan: Why it's time to forget the pecking order at work
Rana el Kaliouby: This app knows how you feel -- from the look on your face
Lee Mokobe: A powerful poem about what it feels like to be transgender
Donald Hoffman: Do we see reality as it is?
Sarah Jones: One woman, five characters, and a sex lesson from the future
Suki Kim: This is what it's like to go undercover in North Korea
Linda Cliatt-Wayman: How to fix a broken school? Lead fearlessly, love hard
Trevor Aaronson: How this FBI strategy is actually creating US-based terrorists
Tony Fadell: The first secret of design is ... noticing
Laura Schulz: The surprisingly logical minds of babies
Bill Gross: The single biggest reason why startups succeed
Jimmy Nelson: Gorgeous portraits of the world's vanishing people
Sara Seager: The search for planets beyond our solar system
Yassmin Abdel-Magied: What does my headscarf mean to you?
Jeffrey Brown: How we cut youth violence in Boston by 79 percent
Chris Burkard: The joy of surfing in ice-cold water
Esther Perel: Rethinking infidelity ... a talk for anyone who has ever loved
Steven Wise: Chimps have feelings and thoughts. They should also have rights
Cosmin Mihaiu: Physical therapy is boring -- play a game instead
Martine Rothblatt: My daughter, my wife, our robot, and the quest for immortality
The Lady Lifers: A moving song from women in prison for life
Roman Mars: Why city flags may be the worst-designed thing you've never noticed
Elora Hardy: Magical houses, made of bamboo
Anand Varma: The first 21 days of a bee’s life
Dawn Landes: A song for my hero, the woman who rowed into a hurricane
Tal Danino: Programming bacteria to detect cancer (and maybe treat it)
Bill T. Jones: The dancer, the singer, the cellist ... and a moment of creative magic
Abe Davis: New video technology that reveals an object's hidden properties
Pamela Ronald: The case for engineering our food
Alice Goffman: How we're priming some kids for college — and others for prison
Sophie Scott: Why we laugh
Greg Gage: How to control someone else's arm with your brain
Nick Bostrom: What happens when our computers get smarter than we are?
Nizar Ibrahim: How we unearthed the Spinosaurus
Clint Smith: How to raise a black son in America
Chris Milk: How virtual reality can create the ultimate empathy machine
Jedidah Isler: How I fell in love with quasars, blazars and our incredible universe
Gary Haugen: The hidden reason for poverty the world needs to address now
Nathalie Cabrol: How Mars might hold the secret to the origin of life
Paul Tudor Jones II: Why we need to rethink capitalism
Takaharu Tezuka: The best kindergarten you’ve ever seen
Kailash Satyarthi: How to make peace? Get angry
Barat Ali Batoor: My desperate journey with a human smuggler
Fred Jansen: How to land on a comet
Dan Ariely: How equal do we want the world to be? You'd be surprised
Eduardo Sáenz de Cabezón: Math is forever
Bel Pesce: 5 ways to kill your dreams
Bill Gates: The next outbreak? We’re not ready
Boniface Mwangi: The day I stood up alone
Kevin Rudd: Are China and the US doomed to conflict?
Daniel Kish: How I use sonar to navigate the world
Alison Killing: There’s a better way to die, and architecture can help
Dame Stephanie Shirley: Why do ambitious women have flat heads?
Theaster Gates: How to revive a neighborhood: with imagination, beauty and art
Dave Isay: Everyone around you has a story the world needs to hear
Anand Giridharadas: A tale of two Americas. And the mini-mart where they collided
Fei-Fei Li: How we're teaching computers to understand pictures
Monica Lewinsky: The price of shame
Joseph DeSimone: What if 3D printing was 100x faster?
David Eagleman: Can we create new senses for humans?
Robyn Stein DeLuca: The good news about PMS
Vincent Cochetel: I was held hostage for 317 days. Here's what I thought about…
Linda Hill: How to manage for collective creativity
Shimpei Takahashi: Play this game to come up with original ideas
Ismael Nazario: What I learned as a kid in jail
Marc Kushner: Why the buildings of the future will be shaped by ... you
Sangu Delle: In praise of macro -- yes, macro -- finance in Africa
Ilona Szabó de Carvalho: 4 lessons I learned from taking a stand against drugs and gun violence
Andy Yen: Think your email's private? Think again
Harry Baker: A love poem for lonely prime numbers
Topher White: What can save the rainforest? Your used cell phone
Jon Gosier: The problem with "trickle-down techonomics"
Helder Guimarães: A magical search for a coincidence
Ben Wellington: How we found the worst place to park in New York City -- using big data
Romina Libster: The power of herd immunity
Khalida Brohi: How I work to protect women from honor killings
Rob Knight: How our microbes make us who we are
James A. White Sr.: The little problem I had renting a house
Angelo Vermeulen: How to go to space, without having to go to space
Laura Boushnak: For these women, reading is a daring act
Nadine Burke Harris: How childhood trauma affects health across a lifetime
Guy Winch: Why we all need to practice emotional first aid
Hannah Fry: The mathematics of love
Kenneth Shinozuka: My simple invention, designed to keep my grandfather safe
Ricardo Semler: How to run a company with (almost) no rules
Jaap de Roode: How butterflies self-medicate
Brian Dettmer: Old books reborn as art
Tom Wujec: Got a wicked problem? First, tell me how you make toast
Ben Ambridge: 10 myths about psychology, debunked
Bruce Aylward: Humanity vs. Ebola. How we could win a terrifying war
Zeynep Tufekci: Online social change: easy to organize, hard to win
Bassam Tariq: The beauty and diversity of Muslim life
Khadija Gbla: My mother’s strange definition of empowerment
Severine Autesserre: To solve mass violence, look to locals
Miguel Nicolelis: Brain-to-brain communication has arrived. How we did it
Morgana Bailey: The danger of hiding who you are
Joe Madiath: Better toilets, better life
Sarah Bergbreiter: Why I make robots the size of a grain of rice
Matthieu Ricard: How to let altruism be your guide
Cristina Domenech: Poetry that frees the soul
Robert Muggah: How to protect fast-growing cities from failing
Robert Swan: Let's save the last pristine continent
Navi Radjou: Creative problem-solving in the face of extreme limits
Tasso Azevedo: Hopeful lessons from the battle to save rainforests
Fredy Peccerelli: A forensic anthropologist who brings closure for the "disappeared"
Aziz Abu Sarah: For more tolerance, we need more ... tourism?
Daniele Quercia: Happy maps
Asha de Vos: Why you should care about whale poo
Michael Rubinstein: See invisible motion, hear silent sounds
Erin McKean: Go ahead, make up new words!
Mundano: Pimp my ... trash cart?
Bruno Torturra: Got a smartphone? Start broadcasting
Carol Dweck: The power of believing that you can improve
Jeremy Howard: The wonderful and terrifying implications of computers that can learn
Vernā Myers: How to overcome our biases? Walk boldly toward them
Dave Troy: Social maps that reveal a city's intersections — and separations
Catherine Crump: The small and surprisingly dangerous detail the police track about you
Thomas Hellum: The world's most boring television ... and why it's hilariously addictive
Anastasia Taylor-Lind: Fighters and mourners of the Ukrainian revolution
Jose Miguel Sokoloff: How Christmas lights helped guerrillas put down their guns
Aakash Odedra: A dance in a hurricane of paper, wind and light
Barbara Natterson-Horowitz: What veterinarians know that physicians don't
Rainer Strack: The workforce crisis of 2030 -- and how to start solving it now
Ben Saunders: To the South Pole and back — the hardest 105 days of my life
Oren Yakobovich: Hidden cameras that film injustice in the world’s most dangerous places
Pico Iyer: The art of stillness
Emily Balcetis: Why some people find exercise harder than others
Mark Plotkin: What the people of the Amazon know that you don’t
Rosie King: How autism freed me to be myself
Joe Landolina: This gel can make you stop bleeding instantly
Nancy Frates: Meet the mom who started the Ice Bucket Challenge
Will Marshall: Tiny satellites show us the Earth as it changes in near-real-time
David Grady: How to save the world (or at least yourself) from bad meetings
Vincent Moon and Naná Vasconcelos: Hidden music rituals around the world
Leana Wen: What your doctor won’t disclose
Ethan Nadelmann: Why we need to end the War on Drugs
Michael Green: What the Social Progress Index can reveal about your country
Ramanan Laxminarayan: The coming crisis in antibiotics
Haas&Hahn: How painting can transform communities
Alejandro Aravena: My architectural philosophy? Bring the community into the process
Kare Anderson: Be an opportunity maker
Ameenah Gurib-Fakim: Humble plants that hide surprising secrets
Alessandra Orofino: It’s our city. Let’s fix it
Jeremy Heimans: What new power looks like
Debra Jarvis: Yes, I survived cancer. But that doesn't define me
Frans Lanting: Photos that give voice to the animal kingdom
Sergei Lupashin: A flying camera ... on a leash
Kimberley Motley: How I defend the rule of law
Marc Abrahams: A science award that makes you laugh, then think
Fabien Cousteau: What I learned from spending 31 days underwater
Joy Sun: Should you donate differently?
Fred Swaniker: The leaders who ruined Africa, and the generation who can fix it
Susan Etlinger: What do we do with all this big data?
Kitra Cahana: My father, locked in his body but soaring free
Melissa Fleming: How to help refugees rebuild their world
Jorge Soto: The future of early cancer detection?
Myriam Sidibe: The simple power of hand-washing
Jeff Iliff: One more reason to get a good night’s sleep
Glenn Greenwald: Why privacy matters
Dilip Ratha: The hidden force in global economics: sending money home
Pia Mancini: How to upgrade democracy for the Internet era
Meaghan Ramsey: Why thinking you're ugly is bad for you
Thomas Piketty: New thoughts on capital in the twenty-first century
Daria van den Bercken: Why I take the piano on the road … and in the air
Nancy Kanwisher: A neural portrait of the human mind
Gail Reed: Where to train the world's doctors? Cuba.
Susan Colantuono: The career advice you probably didn’t get
Francis de los Reyes: Sanitation is a basic human right
Moshe Safdie: How to reinvent the apartment building
Matthew O'Reilly: “Am I dying?” The honest answer.
Eman Mohammed: The courage to tell a hidden story
Kenneth Cukier: Big data is better data
Lord Nicholas Stern: The state of the climate — and what we might do about it
Antonio Donato Nobre: The magic of the Amazon: A river that flows invisibly all around us
Avi Reichental: What’s next in 3D printing
Mac Barnett: Why a good book is a secret door
Andrew Connolly: What's the next window into our universe?
Rishi Manchanda: What makes us get sick? Look upstream
Uldus Bakhtiozina: Wry photos that turn stereotypes upside down
Hans and Ola Rosling: How not to be ignorant about the world
Dan Barasch: A park underneath the hustle and bustle of New York City
Zak Ebrahim: I am the son of a terrorist. Here's how I chose peace.
Colin Grant: How our stories cross over
Shubhendu Sharma: How to grow a tiny forest anywhere
Isabel Allende: How to live passionately—no matter your age
Jim Holt: Why does the universe exist?
Jill Shargaa: Please, please, people. Let's put the 'awe' back in 'awesome'
Sally Kohn: Don't like clickbait? Don't click
Meera Vijayann: Find your voice against gender violence
Rose Goslinga: Crop insurance, an idea worth seeding
Martin Rees: Can we prevent the end of the world?
Ziyah Gafić: Everyday objects, tragic histories
Laurel Braitman: Depressed dogs, cats with OCD — what animal madness means for us humans
Jarrett J. Krosoczka: Why lunch ladies are heroes
Aziza Chaouni: How I brought a river, and my city, back to life
Tim Berners-Lee: A Magna Carta for the web
Clint Smith: The danger of silence
Eric Liu: Why ordinary people need to understand power
Dan Pacholke: How prisons can help inmates live meaningful lives
Nick Hanauer: Beware, fellow plutocrats, the pitchforks are coming
Talithia Williams: Own your body's data
Megan Washington: Why I live in mortal dread of public speaking
Janet Iwasa: How animations can help scientists test a hypothesis
Hubertus Knabe: The dark secrets of a surveillance state
Margaret Gould Stewart: How giant websites design for you (and a billion others, too)
Shai Reshef: An ultra-low-cost college degree
Ze Frank: Are you human?
Heather Barnett: What humans can learn from semi-intelligent slime
Shih Chieh Huang: Sculptures that’d be at home in the deep sea
Nikolai Begg: A tool to fix one of the most dangerous moments in surgery
David Chalmers: How do you explain consciousness?
David Kwong: Two nerdy obsessions meet -- and it's magic
Karima Bennoune: When people of Muslim heritage challenge fundamentalism
Renata Salecl: Our unhealthy obsession with choice
Nicholas Negroponte: A 30-year history of the future
Joi Ito: Want to innovate? Become a "now-ist"
George Takei: Why I love a country that once betrayed me
Paul Bloom: Can prejudice ever be a good thing?
Simon Anholt: Which country does the most good for the world?
Sara Lewis: The loves and lies of fireflies
Chris Domas: The 1s and 0s behind cyber warfare
Julian Treasure: How to speak so that people want to listen
Ge Wang: The DIY orchestra of the future
Naomi Oreskes: Why we should trust scientists
Lorrie Faith Cranor: What’s wrong with your pa$$w0rd?
Shaka Senghor: Why your worst deeds don’t define you
Billy Collins: Two poems about what dogs think (probably)
Jamila Lyiscott: 3 ways to speak English
Ruth Chang: How to make hard choices
Anne Curzan: What makes a word "real"?
Kwame Anthony Appiah: Is religion good or bad? (This is a trick question)
AJ Jacobs: The world's largest family reunion … we're all invited!
Uri Alon: Why truly innovative science demands a leap into the unknown
Will Potter: The shocking move to criminalize nonviolent protest
Keren Elazari: Hackers: the Internet's immune system
Stella Young: I’m not your inspiration, thank you very much
Yoruba Richen: What the gay rights movement learned from the civil rights movement
Robert Full: The secrets of nature's grossest creatures, channeled into robots
Stephen Burt: Why people need poetry
Dan Gilbert: The psychology of your future self
Ray Kurzweil: Get ready for hybrid thinking
Sting: How I started writing songs again
Stephen Friend: The hunt for "unexpected genetic heroes"
Kitra Cahana: A glimpse of life on the road
Jon Mooallem: How the teddy bear taught us compassion
Sebastian Junger: Why veterans miss war
Wes Moore: How to talk to veterans about the war
Chris Kluwe: How augmented reality will change sports ... and build empathy
Andrew Solomon: How the worst moments in our lives make us who we are
Jackie Savitz: Save the oceans, feed the world!
Simon Sinek: Why good leaders make you feel safe
Rives: The Museum of Four in the Morning
Tristram Wyatt: The smelly mystery of the human pheromone
Kevin Briggs: The bridge between suicide and life
Deborah Gordon: What ants teach us about the brain, cancer and the Internet
William Black: How to rob a bank (from the inside, that is)
Mark Ronson: How sampling transformed music
Randall Munroe: Comics that ask "what if?"
Stanley McChrystal: The military case for sharing knowledge
Marco Tempest: And for my next trick, a robot
Mellody Hobson: Color blind or color brave?
Sarah Jones: What does the future hold? 11 characters offer quirky answers
Gavin Schmidt: The emergent patterns of climate change
Andrew Bastawrous: Get your next eye exam on a smartphone
David Epstein: Are athletes really getting faster, better, stronger?
Wendy Chung: Autism — what we know (and what we don’t know yet)
Elizabeth Gilbert: Success, failure and the drive to keep creating
James Patten: The best computer interface? Maybe ... your hands
Hamish Jolly: A shark-deterrent wetsuit (and it's not what you think)
Michel Laberge: How synchronized hammer strikes could generate nuclear fusion
Sarah Lewis: Embrace the near win
Matthew Carter: My life in typefaces
Jeremy Kasdin: The flower-shaped starshade that might help us detect Earth-like planets
Norman Spack: How I help transgender teens become who they want to be
Jennifer Senior: For parents, happiness is a very high bar
David Brooks: Should you live for your résumé ... or your eulogy?
Gabby Giffords and Mark Kelly: Be passionate. Be courageous. Be your best.
David Sengeh: The sore problem of prosthetic limbs
Louie Schwartzberg: Hidden miracles of the natural world
Christopher Emdin: Teach teachers how to create magic
Amanda Burden: How public spaces make cities work
Lawrence Lessig: The unstoppable walk to political reform
Jennifer Golbeck: The curly fry conundrum: Why social media “likes” say more than you might think
Bill and Melinda Gates: Why giving away our wealth has been the most satisfying thing we've done
Allan Adams: The discovery that could rewrite physics
TED staff: It's TED, the Musical
Geena Rocero: Why I must come out
Hugh Herr: The new bionics that let us run, climb and dance
Del Harvey: Protecting Twitter users (sometimes from themselves)
Ed Yong: Zombie roaches and other parasite tales
Bran Ferren: To create for the ages, let's combine art and engineering
Ziauddin Yousafzai: My daughter, Malala
Larry Page: Where’s Google going next?
Richard Ledgett: The NSA responds to Edward Snowden’s TED Talk
Charmian Gooch: My wish: To launch a new era of openness in business
Chris Hadfield: What I learned from going blind in space
Edward Snowden: Here's how we take back the Internet
Daniel Reisel: The neuroscience of restorative justice
Steven Pinker and Rebecca Newberger Goldstein: The long reach of reason
Carin Bondar: The birds and the bees are just the beginning
Toby Shapshak: You don't need an app for that
Anne-Marie Slaughter: Can we all "have it all"?
Clayton Cameron: A-rhythm-etic. The math behind the beats
Ajit Narayanan: A word game to communicate in any language
Manu Prakash: A 50-cent microscope that folds like origami
Gabe Barcia-Colombo: My DNA vending machine
Christopher Soghoian: Government surveillance — this is just the beginning
Philip Evans: How data will transform business
Mary Lou Jepsen: Could future devices read images from our brains?
Annette Heuser: The 3 agencies with the power to make or break economies
Henry Lin: What we can learn from galaxies far, far away
Michael Metcalfe: We need money for aid. So let’s print it.
Catherine Bracy: Why good hackers make good citizens
Siddharthan Chandran: Can the damaged brain repair itself?
Ash Beckham: We're all hiding something. Let's find the courage to open up
Christopher Ryan: Are we designed to be sexual omnivores?
Roselinde Torres: What it takes to be a great leader
Molly Stevens: A new way to grow bone
Yann Dall'Aglio: Love -- you're doing it wrong
Rupal Patel: Synthetic voices, as unique as fingerprints
Chris McKnett: The investment logic for sustainability
Leyla Acaroglu: Paper beats plastic? How to rethink environmental folklore
David Puttnam: Does the media have a "duty of care"?
Aparna Rao: Art that craves your attention
Alex Wissner-Gross: A new equation for intelligence
Teddy Cruz: How architectural innovations migrate across borders
Dan Berkenstock: The world is one big dataset. Now, how to photograph it ...
Esta Soler: How we turned the tide on domestic violence (Hint: the Polaroid helped)
Maya Penn: Meet a young entrepreneur, cartoonist, designer, activist …
Nicolas Perony: Puppies! Now that I’ve got your attention, complexity theory
McKenna Pope: Want to be an activist? Start with your toys
Anne Milgram: Why smart statistics are the key to fighting crime
Anant Agarwal: Why massive open online courses (still) matter
Joe Kowan: How I beat stage fright
Yves Morieux: As work gets more complex, 6 rules to simplify
Paula Johnson: His and hers … healthcare
Shereen El Feki: A little-told tale of sex and sensuality
Guy Hoffman: Robots with "soul"
Luke Syson: How I learned to stop worrying and love "useless" art
Sheryl Sandberg: So we leaned in ... now what?
Mark Kendall: Demo: A needle-free vaccine patch that's safer and way cheaper
Harish Manwani: Profit’s not always the point
Ryan Holladay: To hear this music you have to be there. Literally
Frederic Kaplan: How to build an information time machine
Sandra Aamodt: Why dieting doesn't usually work
Roger Stein: A bold new way to fund drug research
Suzanne Talhouk: Don't kill your language
Maysoon Zayid: I got 99 problems ... palsy is just one
Mick Cornett: How an obese town lost a million pounds
Diana Nyad: Never, ever give up
Paul Piff: Does money make you mean?
Krista Donaldson: The $80 prosthetic knee that's changing lives
Andrew Solomon: Depression, the secret we share
Marco Annunziata: Welcome to the age of the industrial internet
Toni Griffin: A new vision for rebuilding Detroit
Rose George: Inside the secret shipping industry
Stephen Cave: The 4 stories we tell ourselves about death
Eddy Cartaya: My glacier cave discoveries
Diébédo Francis Kéré: How to build with clay ... and community
Boyd Varty: What I learned from Nelson Mandela
Enrique Peñalosa: Why buses represent democracy in action
David Lang: My underwater robot
Sally Kohn: Let’s try emotional correctness
Geraldine Hamilton: Body parts on a chip
Toby Eccles: Invest in social change
David Steindl-Rast: Want to be happy? Be grateful
Suzana Herculano-Houzel: What is so special about the human brain?
Jared Diamond: How societies can grow old better
Peter Doolittle: How your "working memory" makes sense of the world
Andreas Raptopoulos: No roads? There’s a drone for that
Henry Evans and Chad Jenkins: Meet the robots for humanity
Greg Asner: Ecology from the air
Lian Pin Koh: A drone's-eye view of conservation
Jane McGonigal: Massively multi-player… thumb-wrestling?
Stefan Larsson: What doctors can learn from each other
Mohamed Ali: The link between unemployment and terrorism
Chris Downey: Design with the blind in mind
Dambisa Moyo: Is China the new idol for emerging economies?
Arthur Benjamin: The magic of Fibonacci numbers
Mikko Hypponen: How the NSA betrayed the world's trust -- time to act
Grégoire Courtine: The paralyzed rat that walked
Robin Nagle: What I discovered in New York City  trash
Rodrigo Canales: The deadly genius of drug cartels
Dong Woo Jang: The art of bow-making
Holly Morris: Why stay in Chernobyl? Because it's home.
Abha Dawesar: Life in the "digital now"
Mohamed Hijri: A simple solution to the coming phosphorus crisis
Mariana Mazzucato: Government -- investor, risk-taker, innovator
Xavier Vilalta: Architecture at home in its community
Gian Giudice: Why our universe might exist on a knife-edge
Parul Sehgal: An ode to envy
Charles Robertson: Africa's next boom
Steve Howard: Let's go all-in on selling sustainability
Hetain Patel: Who am I? Think again
Alessandro Acquisti: What will a future without secrets look like?
Iwan Baan: Ingenious homes in unexpected places
Amanda Bennett: We need a heroic narrative for death
Jeff Speck: The walkable city
Andrew Fitzgerald: Adventures in Twitter fiction
Gary Slutkin: Let's treat violence like a contagious disease
Trita Parsi: Iran and Israel: Peace is possible
Janette Sadik-Khan: New York's streets? Not so mean any more
Michael Sandel: Why we shouldn't trust markets with our civic life
Michael Porter: The case for letting business solve social problems
Jason Pontin: Can technology solve our big problems?
Fabian Oefner: Psychedelic science
Amy Webb: How I hacked online dating
Kelli Swazey: Life that doesn't end with death
Malcolm Gladwell: The unheard story of David and Goliath
Kevin Breel: Confessions of a depressed comic
James Flynn: Why our IQ levels are higher than our grandparents'
Onora O'Neill: What we don't understand about trust
Stuart Firestein: The pursuit of ignorance
Elizabeth Loftus: How reliable is your memory?
Benjamin Barber: Why mayors should rule the world
Andras Forgacs: Leather and meat without killing animals
Eric Berlow and Sean Gourley: Mapping ideas worth spreading
Marla Spivak: Why bees are disappearing
James Lyne: Everyday cybercrime -- and what you can do about it
Apollo Robbins: The art of misdirection
Sonia Shah: 3 reasons we still haven’t gotten rid of malaria
Ron McCallum: How technology allowed me to read
Jake Barton: The museum of you
George Monbiot: For more wonder, rewild the world
Alexa Meade: Your body is my canvas
Chrystia Freeland: The rise of the new global super-rich
Kelly McGonigal: How to make stress your friend
Adam Spencer: Why I fell in love with monster prime numbers
May El-Khalil: Making peace is a marathon
Steve Ramirez and Xu Liu: A mouse. A laser beam. A manipulated memory.
Russell Foster: Why do we sleep?
Shigeru Ban: Emergency shelters made from paper
Margaret Heffernan: The dangers of "willful blindness"
Derek Paravicini and Adam Ockelford: In the key of genius
Eleanor Longden: The voices in my head
Saki Mafundikwa: Ingenuity and elegance in ancient African alphabets
Jinsop Lee: Design for all 5 senses
Daniel H. Cohen: For argument’s sake
Beardyman: The polyphonic me
Peter van Manen: How can Formula 1 racing help ... babies?
Julie Taymor: Spider-Man, The Lion King and life on the creative edge
Eli Beer: The fastest ambulance? A motorcycle
Bastian Schaefer: A 3D-printed jumbo jet?
Tania Luna: How a penny made me feel like a millionaire
Paul Kemp-Robertson: Bitcoin. Sweat. Tide. Meet the future of branded currency.
Roberto D'Angelo + Francesca Fedeli: In our baby's illness, a life lesson
Kate Stone: DJ decks made of ... paper
John Searle: Our shared condition -- consciousness
Tom Thum: The orchestra in my mouth
Two young scientists break down plastics with bacteria
Pico Iyer: Where is home?
Gavin Pretor-Pinney: Cloudy with a chance of joy
Bernie Krause: The voice of the natural world
Al Vernacchio: Sex needs a new metaphor. Here's one ...
Jack Andraka: A promising test for pancreatic cancer ... from a teenager
The interspecies internet? An idea in progress
Michael Green: Why we should build wooden skyscrapers
Charmian Gooch: Meet global corruption's hidden players
Sleepy Man Banjo Boys: Bluegrass virtuosity from ... New Jersey?
Jinha Lee: Reach into the computer and grab a pixel
Joel Selanikio: The surprising seeds of a big-data revolution in healthcare
Eric X. Li: A tale of two political systems
Rodney Brooks: Why we will rely on robots
Michael Archer: How we'll resurrect the gastric brooding frog, the Tasmanian tiger
Bob Mankoff: Anatomy of a New Yorker cartoon
Peter Attia: Is the obesity crisis hiding a bigger problem?
Lesley Hazleton: The doubt essential to faith
Camille Seaman: Photos from a storm chaser
Paul Pholeros: How to reduce poverty? Fix homes
Joseph Kim: The family I lost in North Korea. And the family I gained.
Juliana Rotich: Meet BRCK, Internet access built for Africa
Didier Sornette: How we can predict the next financial crisis
Manal al-Sharif: A Saudi woman who dared to drive
Daniel Suarez: The kill decision shouldn't belong to a robot
George Papandreou: Imagine a European democracy without borders
Raffaello D'Andrea: The astounding athletic power of quadcopters
Andrew McAfee: What will future jobs look like?
Martin Villeneuve: How I made an impossible film
Denise Herzing: Could we speak the language of dolphins?
Anas Aremeyaw Anas: How I named, shamed and jailed
Alex Laskey: How behavioral science can lower your energy bill
Andrew Solomon: Love, no matter what
Lisa Bu: How books can open your mind
Hendrik Poinar: Bring back the woolly mammoth!
Jackson Katz: Violence against women—it's a men's issue
Paola Antonelli: Why I brought Pac-Man to MoMA
Ji-Hae Park: The violin, and my dark night of the soul
Alastair Parvin: Architecture for the people by the people
Judy MacDonald Johnston: Prepare for a good end of life
Phil Hansen: Embrace the shake
Peter Singer: The why and how of effective altruism
Sergey Brin: Why Google Glass?
Jay Silver: Hack a banana, make a keyboard!
Liu Bolin: The invisible man
Maria Bezaitis: The surprising need for strangeness
Meg Jay: Why 30 is not the new 20
Ken Robinson: How to escape education's death valley
Angela Lee Duckworth: The key to success? Grit
John Legend: "True Colors"
Geoffrey Canada: Our failing schools. Enough is enough!
Malcolm London: "High School Training Ground"
Pearl Arredondo: My story, from gangland daughter to star teacher
Ramsey Musallam: 3 rules to spark learning
Bill Gates: Teachers need real feedback
ShaoLan: Learn to read Chinese ... with ease!
Timothy Bartik: The economic case for preschool
Rita Pierson: Every kid needs a champion
Juan Enriquez: Your online life, permanent as a tattoo
Sebastião Salgado: The silent drama of photography
Taylor Wilson: My radical plan for small nuclear fission reactors
Nilofer Merchant: Got a meeting? Take a walk
David Pogue: 10 top time-saving tech tips
Jennifer Healey: If cars could talk, accidents might be avoidable
Erik Brynjolfsson: The key to growth? Race with the machines
Robert Gordon: The death of innovation, the end of growth
John McWhorter: Txtng is killing language. JK!!!
BLACK: My journey to yo-yo mastery
Andres Lozano: Parkinson's, depression and the switch that might turn them off
Joshua Prager: In search of the man who broke my neck
Thomas Insel: Toward a new understanding of mental illness
Rose George: Let's talk crap. Seriously.
Laura Snyder: The Philosophical Breakfast Club
Eric Dishman: Health care should be a team sport
Dan Ariely: What makes us feel good about our work?
Keller Rinaudo: A mini robot -- powered by your phone
Freeman Hrabowski: 4 pillars of college success in science
Ken Jennings: Watson, Jeopardy and me, the obsolete know-it-all
Skylar Tibbits: The emergence of "4D printing"
Lawrence Lessig: We the People, and the Republic we must reclaim
Sanjay Dastoor: A skateboard, with a boost
Kees Moeliker: How a dead duck changed my life
Colin Camerer: When you're making a deal, what's going on in your brain?
Richard Turere: My invention that made peace with lions
Mark Shaw: One very dry demo
Jessica Green: We're covered in germs. Let's design for that.
Eric Whitacre: Virtual Choir Live
Francis Collins: We need better drugs -- now
Hyeonseo Lee: My escape from North Korea
Elon Musk: The mind behind Tesla, SpaceX, SolarCity ...
Danny Hillis: The Internet could crash. We need a Plan B
Catarina Mota: Play with smart materials
Bono: The good news on poverty (Yes, there's good news)
Stewart Brand: The dawn of de-extinction. Are you ready?
David Anderson: Your brain is more than a bag of chemicals
Dan Pallotta: The way we think about charity is dead wrong
Shane Koyczan: To This Day ... for the bullied and beautiful
Kakenya Ntaiya: A girl who demanded school
Ron Finley: A guerilla gardener in South Central LA
Edith Widder: How we found the giant squid
Allan Savory: How to fight desertification and reverse climate change
Amanda Palmer: The art of asking
Jennifer Granholm: A clean energy proposal -- race to the top!
Sugata Mitra: Build a School in the Cloud
Bruno Maisonnier: Dance, tiny robots!
Bruce Feiler: Agile programming -- for your family
Michael Dickinson: How a fly flies
Andreas Schleicher: Use data to build better schools
Afra Raymond: Three myths about corruption
Keith Chen: Could your language affect your ability to save money?
Miguel Nicolelis: A monkey that controls a robot with its thoughts. No, really.
Young-ha Kim: Be an artist, right now!
Esther Perel: The secret to desire in a long-term relationship
James B. Glattfelder: Who controls the world?
Erik Schlangen: A "self-healing" asphalt
Shabana Basij-Rasikh: Dare to educate Afghan girls
Edi Rama: Take back your city with paint
Lee Cronin: Print your own medicine
Cesar Kuriyama: One second every day
Tyler DeWitt: Hey science teachers -- make it fun
Zahra' Langhi: Why Libya's revolution didn't work -- and what might
Fahad Al-Attiya: A country with no water
iO Tillett Wright: Fifty shades of gay
Mitch Resnick: Let's teach kids to code
Wingham Rowan: A new kind of job market
Leslie Morgan Steiner: Why domestic violence victims don't leave
Steven Schwaitzberg: A universal translator for surgeons
Colin Powell: Kids need structure
Janine di Giovanni: What I saw in the war
Colin Stokes: How movies teach manhood
Richard Weller: Could the sun be good for your heart?
Cameron Russell: Looks aren't everything. Believe me, I'm a model.
Ellen Jorgensen: Biohacking -- you can do it, too
Angela Patton: A father-daughter dance ... in prison
Andy Puddicombe: All it takes is 10 mindful minutes
Boghuma Kabisen Titanji: Ethical riddles in HIV research
Jarrett J. Krosoczka: How a boy became an artist
Sue Austin: Deep sea diving ... in a wheelchair
Jonathan Haidt: How common threats can make common (political) ground
Don Levy: A cinematic journey through visual effects
Hadyn Parry: Re-engineering mosquitos to fight disease
Karen Thompson Walker: What fear can teach us
Ronny Edry: Israel and Iran: A love story?
Adam Davidson: What we learned from teetering on the fiscal cliff
Steven Addis: A father-daughter bond, one photo at a time
Molly Crockett: Beware neuro-bunk
Robin Chase: Excuse me, may I rent your car?
Ben Saunders: Why bother leaving the house?
Marcus Byrne: The dance of the dung beetle
Maz Jobrani: A Saudi, an Indian and an Iranian walk into a Qatari bar ...
Markham Nolan: How to separate fact and fiction online
Ellen 't Hoen: Pool medical patents, save lives
Lemon Andersen: Please don't take my Air Jordans
Nina Tandon: Could tissue engineering mean personalized medicine?
Jeff Smith: Lessons in business ... from prison
Ludwick Marishane: A bath without water
Bobby Ghosh: Why global jihad is losing
Paolo Cardini: Forget multitasking, try monotasking
Munir Virani: Why I love vultures
Janine Shepherd: A broken body isn't a broken person
Jonas Eliasson: How to solve traffic jams
Ernesto Sirolli: Want to help someone? Shut up and listen!
Candy Chang: Before I die I want to ...
Louie Schwartzberg: Nature. Beauty. Gratitude.
Sleepy Man Banjo Boys: Teen wonders play bluegrass
Amos Winter: The cheap all-terrain wheelchair
Daphne Bavelier: Your brain on video games
David Binder: The arts festival revolution
Leah Buechley: How to "sketch" with electronics
Hannah Brencher: Love letters to strangers
Arunachalam Muruganantham: How I started a sanitary napkin revolution!
Julie Burstein: 4 lessons in creativity
Jeff Hancock: The future of lying
Georgette Mulheir: The tragedy of orphanages
Gary Greenberg: The beautiful nano details of our world
Jake Wood: A new mission for veterans -- disaster relief
Matt Killingsworth: Want to be happier? Stay in the moment
Faith Jegede: What I've learned from my autistic brothers
Adam Garone: Healthier men, one moustache at a time
Emma Teeling: The secret of the bat genome
Sanjay Pradhan: How open data is changing international aid
Rory Stewart: Why democracy matters
Marco Tempest: A cyber-magic card trick like no other
Doris Kim Sung: Metal that breathes
Lemn Sissay: A child of the state
David Pizarro: The strange politics of disgust
Pankaj Ghemawat: Actually, the world isn't flat
Ryan Merkley: Online video -- annotated, remixed and popped
Heather Brooke: My battle to expose government corruption
Beau Lotto + Amy O'Toole: Science is for everyone, kids included
John Wilbanks: Let's pool our medical data
Eddie Obeng: Smart failure for a fast-changing world
Maurizio Seracini: The secret lives of paintings
Melissa Marshall: Talk nerdy to me
Ruby Wax: What's so funny about mental illness?
John Maeda: How art, technology and design inform creative leaders
Tim Leberecht: 3 ways to (usefully) lose control of your brand
Thomas P. Campbell: Weaving narratives in museum galleries
Shimon Schocken: The self-organizing computer course
Jason McCue: Terrorism is a failed brand
Robert Gupta: Between music and medicine
Amy Cuddy: Your body language shapes who you are
Vicki Arroyo: Let's prepare for our new climate
Aris Venetikidis: Making sense of maps
Bahia Shehab: A thousand times no
Ben Goldacre: What doctors don't know about the drugs they prescribe
Clay Shirky: How the Internet will (one day) transform government
Read Montague: What we're learning from 5,000 brains
Andrew McAfee: Are droids taking our jobs?
Rachel Botsman: The currency of the new economy is trust
Ed Gavagan: A story about knots and surgeons
Bandi Mbubi: Demand a fair trade cell phone
Andrew Blum: Discover the physical side of the internet
Julian Treasure: Why architects need to use their ears
Sarah-Jayne Blakemore: The mysterious workings of the adolescent brain
Tristram Stuart: The global food waste scandal
Beth Noveck: Demand a more open-source government
Wayne McGregor: A choreographer's creative process in real time
Susan Solomon: The promise of research with stem cells
Leslie T. Chang: The voices of China's workers
Vikram Patel: Mental health for all by involving all
Scott Fraser: Why eyewitnesses get it wrong
Kent Larson: Brilliant designs to fit more people in every city
Jonathan Trent: Energy from floating algae pods
Antony Gormley: Sculpted space, within and without
Shyam Sankar: The rise of human-computer cooperation
Robert Neuwirth: The power of the informal economy
Rob Legato: The art of creating awe
Timothy Prestero: Design for people, not awards
Jon Ronson: Strange answers to the psychopath test
Caitria + Morgan O'Neill: How to step up in the face of disaster
Ivan Krastev: Can democracy exist without trust?
Mark Forsyth: What's a snollygoster? A short lesson in political speak
Lisa Kristine: Photos that bear witness to modern slavery
Kirby Ferguson: Embrace the remix
Pam Warhurst: How we can eat our landscapes
Max Little: A test for Parkinson's with a phone call
Margaret Heffernan: Dare to disagree
Scilla Elworthy: Fighting with nonviolence
Mark Applebaum: The mad scientist of music
Becci Manson: (Re)touching lives through photos
Daphne Koller: What we're learning from online education
Stephen Ritz: A teacher growing green in the South Bronx
Michael Anti: Behind the Great Firewall of China
Noah Wilson-Rich: Every city needs healthy honey bees
Michael Hansmeyer: Building unimaginable shapes
Ramesh Raskar: Imaging at a trillion frames per second
Tracy Chevalier: Finding the story inside the painting
Malte Spitz: Your phone company is watching
James Stavridis: A Navy Admiral's thoughts on global security
Vinay Venkatraman: Technology crafts for the digitally underserved
John Graham-Cumming: The greatest machine that never was
Neil Harbisson: I listen to color
Matt Mills: Image recognition that triggers augmented reality
Baba Shiv: Sometimes it's good to give up the driver's seat
Jamie Drummond: Let's crowdsource the world's goals
Mina Bissell: Experiments that point to a new understanding of cancer
Gabriel Barcia-Colombo: Capturing memories in video art
Todd Humphreys: How to fool a GPS
Jared Ficklin: New ways to see music (with color! and fire!)
Marc Goodman: A vision of crimes in the future
Chris Gerdes: The future race car -- 150mph, and no driver
Jonathan Eisen: Meet your microbes
Jane McGonigal: The game that can give you 10 extra years of life
Usman Riaz + Preston Reed: A young guitarist meets his hero
Cesar Harada: A novel idea for cleaning up oil spills
Raghava KK: What's your 200-year plan?
Alanna Shaikh: How I'm preparing to get Alzheimer's
Boaz Almog: The levitating superconductor
Elyn Saks: A tale of mental illness -- from the inside
Don Tapscott: Four principles for the open world
Massimo Banzi: How Arduino is open-sourcing imagination
Rives: Reinventing the encyclopedia game
E.O. Wilson: Advice to young scientists
Nirmalya Kumar: India's invisible innovation
Jon Nguyen: Tour the solar system from home
Wolfgang Kessling: How to air-condition outdoor spaces
Peter Norvig: The 100,000-student classroom
Marco Tempest: The electric rise and fall of Nikola Tesla
Ivan Oransky: Are we over-medicalized?
David R. Dow: Lessons from death row inmates
Megan Kamerick: Women should represent women in media
Rodney Mullen: Pop an ollie and innovate!
LZ Granderson: The myth of the gay agenda
Sarah Parcak: Archaeology from space
Beeban Kidron: The shared wonder of film
Rebecca Onie: What if our healthcare system kept us healthy?
John Hockenberry: We are all designers
Ami Klin: A new way to diagnose autism
John Hodgman: Design, explained.
Damian Palin: Mining minerals from seawater
Terry Moore: Why is 'x' the unknown?
Diane Kelly: What we didn't know about penis anatomy
Juan Enriquez: Will our kids be a different species?
David Birch: A new way to stop identity theft
Seth Shostak: ET is (probably) out there -- get ready
Quixotic Fusion: Dancing with light
Sebastian Deterding: What your designs say about you
Dalia Mogahed: The attitudes that sparked Arab Spring
William Noel: Revealing the lost codex of Archimedes
Ken Goldberg: 4 lessons from robots about being human
David MacKay: A reality check on renewables
Reggie Watts: Beats that defy boxes
Shereen El-Feki: HIV -- how to fight an epidemic of bad laws
Philippe Petit: The journey across the high wire
Hans Rosling: Religions and babies
Nathan Wolfe: What's left to explore?
Michael McDaniel: Cheap, effective shelter for disaster relief
JR: One year of turning the world inside out
Carl Schoonover: How to look inside the brain
David Kelley: How to build your creative confidence
Jean-Baptiste Michel: The mathematics of history
Tali Sharot: The optimism bias
Bart Knols: 3 new ways to kill mosquitoes
Renny Gleeson: 404, the story of a page not found
Joshua Foer: Feats of memory anyone can do
Karen Bass: Unseen footage, untamed nature
JP Rangaswami: Information is food
Michael Tilson Thomas: Music and emotion through time
Tavi Gevinson: A teen just trying to figure it out
Rory Sutherland: Perspective is everything
Gary Kovacs: Tracking our online trackers
Reuben Margolin: Sculpting waves in wood and time
Amory Lovins: A 40-year plan for energy
Liz Diller: A new museum wing ... in a giant bubble
Brenda Romero: Gaming for understanding
Joe Smith: How to use a paper towel
Nancy Lublin: Texting that saves lives
Eduardo Paes: The 4 commandments of cities
Michael Norton: How to buy happiness
Brian Greene: Is our universe the only universe?
Christina Warinner: Tracking ancient diseases using ... plaque
Laura Carstensen: Older people are happier
Taryn Simon: The stories behind the bloodlines
Drew Curtis: How I beat a patent troll
Atul Gawande: How do we heal medicine?
Abigail Washburn: Building US-China relations ... by banjo
Tal Golesworthy: How I repaired my own heart
Melinda Gates: Let's put birth control back on the agenda
Frans de Waal: Moral behavior in animals
Frank Warren: Half a million secrets
Jonathan Foley: The other inconvenient truth
Lucy McRae: How can technology transform the human body?
Jack Choi: On the virtual dissection table
Chip Kidd: Designing books is no laughing matter. OK, it is.
Sherry Turkle: Connected, but alone?
Marco Tempest: A magical tale (with augmented reality)
Ayah Bdeir: Building blocks that blink, beep and teach
Leymah Gbowee: Unlock the intelligence, passion, greatness of girls
Regina Dugan: From mach-20 glider to hummingbird drone
Donald Sadoway: The missing link to renewable energy
Peter Saul: Let's talk about dying
Billy Collins: Everyday moments, caught in time
Taylor Wilson: Yup, I built a nuclear fusion reactor
Noel Bairey Merz: The single biggest health threat women face
T. Boone Pickens: Let's transform energy -- with natural gas
Brené Brown: Listening to shame
Rob Reid: The $8 billion iPod
Jonathan Haidt: Religion, evolution, and the ecstasy of self-transcendence
Larry Smith: Why you will fail to have a great career
Improv Everywhere: A TED speaker's worst nightmare
Jennifer Pahlka: Coding a better government
James Hansen: Why I must speak out about climate change
Andrew Stanton: The clues to a great story
Bryan Stevenson: We need to talk about an injustice
Susan Cain: The power of introverts
Vijay Kumar: Robots that fly ... and cooperate
Peter Diamandis: Abundance is our future
Paul Gilding: The Earth is full
Daniel Pauly: The ocean's shifting baseline
Paul Snelgrove: A census of the ocean
Kevin Allocca: Why videos go viral
Avi Rubin: All your devices can be hacked
Tan Le: My immigration story
Shlomo Benartzi: Saving for tomorrow, tomorrow
Shilo Shiv Suleman: Using tech to enable dreaming
Chris Bliss: Comedy is translation
Neil MacGregor: 2600 years of history in one object
Garth Lenz: The true cost of oil
Paul Conneally: How mobile phones power disaster relief
Simon Berrow: How do you save a shark you know nothing about?
Lucien Engelen: Crowdsource your health
Jenna McCarthy: What you don't know about marriage
Tyrone Hayes + Penelope Jagessar Chaffer: The toxic baby
Drew Dudley: Everyday leadership
Erik Johansson: Impossible photography
Jack Horner: Where are the baby dinosaurs?
Sheikha Al Mayassa: Globalizing the local, localizing the global
Stephen Coleman: Non-lethal weapons, a moral hazard?
Neil Burgess: How your brain tells you where you are
Mike deGruy: Hooked by an octopus
Danny Hillis: Back to the future (of 1994)
Erica Frenkel: The universal anesthesia machine
Shawn Achor: The happy secret to better work
Bill Doyle: Treating cancer with electric fields
Peter van Uhm: Why I chose a gun
Mick Mountz: What happens inside those massive warehouses?
Gayle Tzemach Lemmon: Women entrepreneurs, example not exception
Brian Goldman: Doctors make mistakes. Can we talk about that?
Diana Nyad: Extreme swimming with the world's most dangerous jellyfish
Lisa Harouni: A primer on 3D printing
Julian Baggini: Is there a real you?
Bilal Bomani: Plant fuels that could power a jet
Sheena Iyengar: How to make choosing easier
Clay Shirky: Why SOPA is a bad idea
Mikko Hypponen: Three types of online attack
Alain de Botton: Atheism 2.0
Sonaar Luthra: Meet the Water Canary
Morley: "Women of Hope"
Drew Berry: Animations of unseeable biology
Jonas Gahr Støre: In defense of dialogue
Lauren Hodge, Shree Bose + Naomi Shah: Award-winning teenage science in action
Sebastian Wernicke: 1,000 TED Talks in six words
Paddy Ashdown: The global power shift
Jane Fonda: Life's third act
AJ Jacobs: How healthy living nearly killed me
Alberto Cairo: There are no scraps of men
Karen Tse: How to stop torture
Daniel Goldstein: The battle between your present and future self
Sheila Nirenberg: A prosthetic eye to treat blindness
Antonio Damasio: The quest to understand consciousness
Ramona Pierson: An unexpected place of healing
Homaro Cantu + Ben Roche: Cooking as alchemy
Pavan Sukhdev: Put a value on nature!
Quyen Nguyen: Color-coded surgery
Monika Bulaj: The hidden light of Afghanistan
Stefon Harris: There are no mistakes on the bandstand
Yoav Medan: Ultrasound surgery -- healing without cuts
Cheryl Hayashi: The magnificence of spider silk
Luis von Ahn: Massive-scale online collaboration
Srdja Popovic: How to topple a dictator
Kathryn Schulz: Don't regret regret
Charles Limb: Building the musical muscle
John Bohannon: Dance vs. powerpoint, a modest proposal
Annie Murphy Paul: What we learn before we're born
Damon Horowitz: Philosophy in prison
Amy Purdy: Living beyond limits
Britta Riley: A garden in my apartment
Joe Sabia: The technology of storytelling
Péter Fankhauser: Meet Rezero, the dancing ballbot
Phil Plait: How to defend Earth from asteroids
Robin Ince: Science versus wonder?
Cynthia Kenyon: Experiments that hint of longer lives
Thomas Suarez: A 12-year-old app developer
Yves Rossy: Fly with the Jetman
Alexander Tsiaras: Conception to birth -- visualized
Charlie Todd: The shared experience of absurdity
Allan Jones: A map of the brain
Ben Kacyra: Ancient wonders captured in 3D
Aparna Rao: High-tech art (with a sense of humor)
Martin Hanczyc: The line between life and not-life
Marco Tempest: Augmented reality, techno-magic
Daniel Wolpert: The real reason for brains
Anna Mracek Dietrich: A plane you can drive
Paul Zak: Trust, morality -- and oxytocin?
Hasan Elahi: FBI, here I am!
Béatrice Coron: Stories cut from paper
Jay Bradner: Open-source cancer research
Malcolm Gladwell: The strange tale of the Norden bombsight
Richard Wilkinson: How economic inequality harms societies
Nathalie Miebach: Art made of storms
Todd Kuiken: A prosthetic arm that "feels"
Guy-Philippe Goldstein: How cyberattacks threaten real-world peace
Justin Hall-Tipping: Freeing energy from the grid
Bunker Roy: Learning from a barefoot movement
Jae Rhim Lee: My mushroom burial suit
Pamela Meyer: How to spot a liar
Ian Ritchie: The day I turned down Tim Berners-Lee
Richard Seymour: How beauty feels
Alison Gopnik: What do babies think?
Charles Hazlewood: Trusting the ensemble
Mike Biddle: We can recycle plastic
Graham Hill: Less stuff, more happiness
Christoph Adami: Finding life we can't imagine
Yang Lan: The generation that's remaking China
Danielle de Niese: A flirtatious aria
Ben Goldacre: Battling bad science
Jarreth Merz: Filming democracy in Ghana
Geoff Mulgan: A short intro to the Studio School
Abraham Verghese: A doctor's touch
Sunni Brown: Doodlers, unite!
Elizabeth Murchison: Fighting a contagious cancer
Amy Lockwood: Selling condoms in the Congo
Jean-Baptiste Michel + Erez Lieberman Aiden: What we learned from 5 million books
Niall Ferguson: The 6 killer apps of prosperity
Lauren Zalaznick: The conscience of television
Richard Resnick: Welcome to the genomic revolution
Kate Hartman: The art of wearable communication
Misha Glenny: Hire the hackers!
Yasheng Huang: Does democracy stifle economic growth?
Raghava KK: Shake up your story
Lee Cronin: Making matter come alive
Sarah Kaminsky: My father the forger
Edward Tenner: Unintended consequences
Joan Halifax: Compassion and the true meaning of empathy
Skylar Tibbits: Can we make things that make themselves?
Julia Bacha: Pay attention to nonviolence
Svante Pääbo: DNA clues to our inner neanderthal
Dan Ariely: Beware conflicts of interest
Marco Tempest: The magic of truth and lies (and iPods)
Lucianne Walkowicz: Finding planets around other stars
Jeremy Gilley: One day of peace
Dyan deNapoli: The great penguin rescue
Alex Steffen: The shareable future of cities
Eve Ensler: Suddenly, my body
Philip Zimbardo: The demise of guys?
Jessica Green: Are we filtering the wrong microbes?
Mark Pagel: How language transformed humanity
Harald Haas: Wireless data from every light bulb
Adam Ostrow: After your final status update
Julian Treasure: 5 ways to listen better
Josette Sheeran: Ending hunger now
Paul Bloom: The origins of pleasure
Geoffrey West: The surprising math of cities and corporations
Rory Stewart: Time to end the war in Afghanistan
Markus Fischer: A robot that flies like a bird
Kevin Slavin: How algorithms shape our world
Thandie Newton: Embracing otherness, embracing myself
Mikko Hypponen: Fighting viruses, defending the net
Nadia Al-Sakkaf: See Yemen through my eyes
Tim Harford: Trial, error and the God complex
Maajid Nawaz: A global culture to fight extremism
Rebecca MacKinnon: Let's take back the Internet!
Nina Tandon: Caring for engineered tissue
Simon Lewis: Don't take consciousness for granted
Jonathan Drori: The beautiful tricks of flowers
Nathan Myhrvold: Cooking as never seen before
Matt Cutts: Try something new for 30 days
Robert Hammond: Building a park in the sky
Dave deBronkart: Meet e-Patient Dave
Rajesh Rao: A Rosetta Stone for a lost language
Emiliano Salinas: A civil response to violence
Joshua Walters: On being just crazy enough
Honor Harger: A history of the universe in sound
Jok Church: A circle of caring
Daniel Tammet: Different ways of knowing
Bill Ford: A future beyond traffic gridlock
Maya Beiser: A cello with many voices
Onyx Ashanti: This is beatjazz
Camille Seaman: Haunting photos of polar ice
Steve Keil: A manifesto for play, for Bulgaria and beyond
Shea Hembrey: How I became 100 artists
Daniel Kraft: Medicine's future? There's an app for that
JD Schramm: Break the silence for suicide attempt survivors
Alice Dreger: Is anatomy destiny?
Paul Romer: The world's first charter city?
Janet Echelman: Taking imagination seriously
Jack Horner: Building a dinosaur from a chicken
Damon Horowitz: We need a "moral operating system"
Jessi Arrington: Wearing nothing new
Aaron O'Connell: Making sense of a visible quantum object
Stefan Sagmeister: 7 rules for making more happiness
Dennis Hong: Making a car for blind drivers
Robert Gupta + Joshua Roman: On violin and cello, "Passacaglia"
Mustafa Akyol: Faith versus tradition in Islam
Shirin Neshat: Art in exile
Bruce Aylward: How we'll stop polio for good
Aaron Koblin: Visualizing ourselves ... with crowd-sourced data
Terry Moore: How to tie your shoes
Edith Widder: The weird, wonderful world of bioluminescence
Elliot Krane: The mystery of chronic pain
Thomas Heatherwick: Building the Seed Cathedral
Ed Boyden: A light switch for neurons
Leonard Susskind: My friend Richard Feynman
Amit Sood: Building a museum of museums on the web
Ron Gutman: The hidden power of smiling
Fiorenzo Omenetto: Silk, the ancient material of the future
Paul Nicklen: Tales of ice-bound wonderlands
Louie Schwartzberg: The hidden beauty of pollination
Sean Carroll: Distant time and the hint of a multiverse
Suzanne Lee: Grow your own clothes
Carlo Ratti: Architecture that senses and responds
Aicha el-Wafi + Phyllis Rodriguez: The mothers who found forgiveness, friendship
Eli Pariser: Beware online "filter bubbles"
Arvind Gupta: Turning trash into toys for learning
Mike Matas: A next-generation digital book
Angela Belcher: Using nature to grow batteries
Bruce Schneier: The security mirage
Harvey Fineberg: Are we ready for neo-evolution?
Ric Elias: 3 things I learned while my plane crashed
Anil Ananthaswamy: What it takes to do extreme astrophysics
John Hunter: Teaching with the World Peace Game
Kathryn Schulz: On being wrong
Sam Richards: A radical experiment in empathy
Susan Lim: Transplant cells, not organs
Marcin Jakubowski: Open-sourced blueprints for civilization
Roger Ebert: Remaking my voice
Dave Meslin: The antidote to apathy
David Christian: The history of our world in 18 minutes
Jackson Browne: A song inspired by the ocean
Caroline Casey: Looking past limits
Mick Ebeling: The invention that unlocked a locked-in artist
Morgan Spurlock: The greatest TED Talk ever sold
Chade-Meng Tan: Everyday compassion at Google
Stanley McChrystal: Listen, learn ... then lead
AnnMarie Thomas: Hands-on science with squishy circuits
Eric Whitacre: A virtual choir 2,000 voices strong
Sebastian Thrun: Google's driverless car
Handspring Puppet Co.: The genius puppetry behind War Horse
Ralph Langner: Cracking Stuxnet, a 21st-century cyber weapon
Patricia Ryan: Don't insist on English!
Claron McFadden: Singing the primal mystery
Eythor Bender: Human exoskeletons -- for war and healing
Paul Root Wolpe: It's time to question bio-engineering
Isabel Behncke: Evolution's gift of play, from bonobo apes to humans
Hans Rosling: The magic washing machine
Sarah Kay: If I should have a daughter ...
Rogier van der Heide: Why light needs darkness
Mark Bezos: A life lesson from a volunteer firefighter
Janna Levin: The sound the universe makes
David Brooks: The social animal
Rob Harmon: How to keep rivers and streams flowing
Deb Roy: The birth of a word
Salman Khan: Let's use video to reinvent education
Courtney Martin: This isn't her mother's feminism
Anthony Atala: Printing a human kidney
Bill Gates: How state budgets are breaking US schools
Wael Ghonim: Inside the Egyptian revolution
JR: My wish: Use art to turn the world inside out
Wadah Khanfar: A historic moment in the Arab world
Ahn Trio: A modern take on piano, violin, cello
Danny Hillis: Understanding cancer through proteomics
Elizabeth Lindsey: Curating humanity's heritage
Iain Hutchison: Saving faces: A facial surgeon's craft
Noreena Hertz: How to use experts -- and when not to
Madeleine Albright: On being a woman and a diplomat
Lisa Gansky: The future of business is the "mesh"
Jacqueline Novogratz: Inspiring a life of immersion
Patricia Kuhl: The linguistic genius of babies
Krista Tippett: Reconnecting with compassion
Geert Chatrou: A whistleblower you haven't heard
Michael Pawlyn: Using nature's genius in architecture
Hawa Abdi + Deqo Mohamed: Mother and daughter doctor-heroes
Cynthia Breazeal: The rise of personal robots
Nigel Marsh: How to make work-life balance work
Suheir Hammad: Poems of war, peace, women, power
Christopher McDougall: Are we born to run?
Johanna Blakley: Social media and the end of gender
Dale Dougherty: We are makers
Kate Orff: Reviving New York's rivers -- with oysters!
Bruce Feiler: The council of dads
Ariel Garten: Know thyself, with a brain scanner
Liza Donnelly: Drawing on humor for change
Thomas Goetz: It's time to redesign medical data
Martin Jacques: Understanding the rise of China
Heather Knight: Silicon-based comedy
Anders Ynnerman: Visualizing the medical data explosion
Van Jones: The economic injustice of plastic
Charity Tillemann-Dick: Singing after a double lung transplant
Naomi Klein: Addicted to risk
Ali Carr-Chellman: Gaming to re-engage boys in learning
Elizabeth Lesser: Take "the Other" to lunch
Thomas Thwaites: How I built a toaster -- from scratch
Amber Case: We are all cyborgs now
Jody Williams: A realistic vision for world peace
Neil Pasricha: The 3 A's of awesome
Deborah Rhodes: A test that finds 3x more breast tumors, and why it's not available to you
Charles Limb: Your brain on improv
Lesley Hazleton: On reading the Koran
Arianna Huffington: How to succeed? Get more sleep
Barry Schwartz: Using our practical wisdom
Brené Brown: The power of vulnerability
Majora Carter: 3 stories of local eco-entrepreneurship
Sheryl Sandberg: Why we have too few women leaders
Beverly + Dereck Joubert: Life lessons from big cats
Rachel Botsman: The case for collaborative consumption
Rufus Griscom + Alisa Volkman: Let's talk parenting taboos
Diana Laufenberg: How to learn? From mistakes
Hanna Rosin: New data on the rise of women
Kiran Bedi: A police chief with a difference
Tony Porter: A call to men
Halla Tomasdottir: A feminine response to Iceland's financial crash
Arthur Potts Dawson: A vision for sustainable restaurants
Bart Weetjens: How I taught rats to sniff out land mines
Marcel Dicke: Why not eat insects?
William Ury: The walk from "no" to "yes"
Birke Baehr: What's wrong with our food system
Dan Phillips: Creative houses from reclaimed stuff
Jason Fried: Why work doesn't happen at work
Zainab Salbi: Women, wartime and the dream of peace
Kim Gorgens: Protecting the brain against concussion
Kristina Gjerde: Making law on the high seas
John Hardy: My green school dream
Shimon Schocken: What a bike ride can teach you
Denis Dutton: A Darwinian theory of beauty
Conrad Wolfram: Teaching kids real math with computers
Eric Berlow: Simplifying complexity
Auret van Heerden: Making global labor fair
Aaron Huey: America's native prisoners of war
Stefan Wolff: The path to ending ethnic conflicts
Emily Pilloton: Teaching design for change
Andrew Bird: A one-man orchestra of the imagination
Gero Miesenboeck: Re-engineering the brain
Greg Stone: Saving the ocean one island at a time
David Bismark: E-voting without fraud
Tom Chatfield: 7 ways games reward the brain
Miwa Matreyek: Glorious visions in animation and performance
Shimon Steinberg: Natural pest control ... using bugs!
Barton Seaver: Sustainable seafood? Let's get smart
Joseph Nye: Global power shifts
R.A. Mashelkar: Breakthrough designs for ultra-low-cost products
David Byrne, Ethel + Thomas Dolby: "(Nothing But) Flowers" with string quartet
Patrick Chappatte: The power of cartoons
Dianna Cohen: Tough truths about plastic pollution
Heribert Watzke: The brain in your gut
Jessica Jackley: Poverty, money -- and love
Ze Frank: My web playroom
Natalie Jeremijenko: The art of the eco-mindshift
Peter Haas: Haiti's disaster of engineering
Melinda Gates: What nonprofits can learn from Coca-Cola
Stefano Mancuso: The roots of plant intelligence
Stacey Kramer: The best gift I ever survived
Hans Rosling: The good news of the decade? We're winning the war against child mortality
Barbara Block: Tagging tuna in the deep ocean
Tim Jackson: An economic reality check
Eben Bayer: Are mushrooms the new plastic?
Mechai Viravaidya: How Mr. Condom made Thailand a better place for life and love
Inge Missmahl: Bringing peace to the minds of Afghanistan
Sebastian Seung: I am my connectome
Gary Wolf: The quantified self
Julian Treasure: Shh! Sound health in 8 steps
Fabian Hemmert: The shape-shifting future of the mobile phone
Annie Lennox: Why I am an HIV/AIDS activist
Mitchell Besser: Mothers helping mothers fight HIV
Steven Johnson: Where good ideas come from
Christien Meindertsma: How pig parts make the world turn
Caroline Phillips: Hurdy-gurdy for beginners
Nicholas Christakis: How social networks predict epidemics
Jessa Gamble: Our natural sleep cycle is nothing like what we do now
Chris Anderson: How web video powers global innovation
Rob Dunbar: Discovering ancient climates in oceans and ice
Ben Cameron: Why the live arts matter
Carne Ross: An independent diplomat
Alwar Balasubramaniam: Art of substance and absence
Sugata Mitra: The child-driven education
Rachel Sussman: The world's oldest living things
Derek Sivers: Keep your goals to yourself
His Holiness the Karmapa: The technology of the heart
Johan Rockstrom: Let the environment guide our development
Nic Marks: The Happy Planet Index
Dan Cobley: What physics taught me about marketing
Lisa Margonelli: The political chemistry of oil
Jim Toomey: Learning from Sherman the shark
Lee Hotz: Inside an Antarctic time machine
David McCandless: The beauty of data visualization
Seth Priebatsch: The game layer on top of the world
Maz Jobrani: Did you hear the one about the Iranian-American?
Jamil Abu-Wardeh: The Axis of Evil Middle East Comedy Tour
Peter Molyneux: Meet Milo, the virtual boy
Sheryl WuDunn: Our century's greatest injustice
Jason Clay: How big brands can help save biodiversity
Lewis Pugh: My mind-shifting Everest swim
Laurie Santos: A monkey economy as irrational as ours
John Delaney: Wiring an interactive ocean
Sheena Iyengar: The art of choosing
Kevin Stone: The bio-future of joint replacement
Tan Le: A headset that reads your brainwaves
Dimitar Sasselov: How we found hundreds of potential Earth-like planets
Naif Al-Mutawa: Superheroes inspired by Islam
Julian Assange: Why the world needs WikiLeaks
Elif Shafak: The politics of fiction
Ethan Zuckerman: Listening to global voices
Matt Ridley: When ideas have sex
Carl Safina: The oil spill's unseen villains -- and victims
Hans Rosling: Global population growth, box by box
Nalini Nadkarni: Life science in prison
Ellen  Gustafson: Obesity + hunger = 1 global food issue
Benoit Mandelbrot: Fractals and the art of roughness
Mitchell Joachim: Don't build your home, grow it!
Carter Emmart: A 3D atlas of the universe
Stephen Palumbi: Hidden toxins in the fish we eat
Ellen Dunham-Jones: Retrofitting suburbia
Clay Shirky: How cognitive surplus will change the world
Hillel Cooperman: Legos for grownups
Aditi Shankardass: A second opinion on developmental disorders
Charles Leadbeater: Education innovation in the slums
Marian Bantjes: Intricate beauty by design
Chip Conley: Measuring what makes life worthwhile
Ananda Shankar Jayant: Fighting cancer with dance
Cameron Herold: Let's raise kids to be entrepreneurs
Peter Tyack: The intriguing sound of marine mammals
Margaret Gould Stewart: How YouTube thinks about copyright
Michael Shermer: The pattern behind self-deception
David Byrne: How architecture helped music evolve
Stewart Brand + Mark Z. Jacobson: Debate: Does the world need nuclear energy?
Rory Sutherland: Sweat the small stuff
John Kasaona: How poachers became caretakers
Michael Sandel: The lost art of democratic debate
Adam Sadowsky: How to engineer a viral music video
Brian Cox: Why we need the explorers
Christopher "moot" Poole": The case for anonymity online
Brian Skerry: The ocean's glory -- and horror
John Underkoffler: Pointing to the future of UI
Lawrence Lessig: Re-examining the remix
Seth Berkley: HIV and flu -- the vaccine strategy
Sharmeen Obaid-Chinoy: Inside a school for suicide bombers
Johanna Blakley: Lessons from fashion's free culture
Ken Robinson: Bring on the learning revolution!
Craig Venter: Watch me unveil "synthetic life"
Richard Sears: Planning for the end of oil
Dee Boersma: Pay attention to penguins
Graham Hill: Why I'm a weekday vegetarian
William Li: Can we eat to starve cancer?
Julia Sweeney: It's time for "The Talk"
Dan Meyer: Math class needs a makeover
Enric Sala: Glimpses of a pristine ocean
Nathan Myhrvold: Could this laser zap malaria?
Nicholas Christakis: The hidden influence of social networks
Thomas Dolby: "Love Is a Loaded Pistol"
Anil Gupta: India's hidden hotbeds of invention
Jeremy Jackson: How we wrecked the ocean
Simon Sinek: How great leaders inspire action
Esther Duflo: Social experiments to fight poverty
Sebastian Wernicke: Lies, damned lies and statistics (about TEDTalks)
George Whitesides: Toward a science of simplicity
Roz Savage: Why I'm rowing across the Pacific
Stephen Wolfram: Computing a theory of all knowledge
Kavita Ramdas: Radical women, embracing tradition
Omar Ahmad: Political change with pen and paper
Tom Wujec: Build a tower, build a team
Frederick Balagadde: Bio-lab on a microchip
James Randi: Homeopathy, quackery and fraud
Edith Widder: Glowing life in an underwater world
Thelma Golden: How art gives shape to cultural change
Catherine Mohr: The tradeoffs of building green
Jonathan Klein: Photos that changed the world
Michael Specter: The danger of science denial
Natalie Merchant: Singing old poems to life
Jonathan Drori: Every pollen grain has a story
Dennis Hong: My seven species of robot -- and how we created them
Dean Kamen: The emotion behind invention
Elizabeth Pisani: Sex, drugs and HIV -- let's get rational
Adora Svitak: What adults can learn from kids
Derek Sivers: How to start a movement
Kirk Citron: And now, the real news
Shukla Bose: Teaching one child at a time
Kevin Bales: How to combat modern slavery
Robert Gupta: Music is medicine, music is sanity
Joel Levine: Why we need to go back to Mars
Alan Siegel: Let's simplify legal jargon!
Juliana Machado Ferreira: The fight to end rare-animal trafficking in Brazil
Sam Harris: Science can answer moral questions
Shekhar Kapur: We are the stories we tell ourselves
Ken Kamler: Medical miracle on Everest
Jane McGonigal: Gaming can make a better world
Eric Dishman: Take health care off the mainframe
Mark Roth: Suspended animation is within our grasp
Eric Mead: The magic of the placebo
Dan Barber: How I fell in love with a fish
Gary Lauder's new traffic sign: Take Turns
Tim Berners-Lee: The year open data went worldwide
The LXD: In the Internet age, dance evolves ...
James Cameron: Before Avatar ... a curious boy
Gary Flake: Is Pivot a turning point for web exploration?
Harsha Bhogle: The rise of cricket, the rise of India
Daniel Kahneman: The riddle of experience vs. memory
Raghava KK: My 5 lives as an artist
Pawan Sinha: How brains learn to see
Temple Grandin: The world needs all kinds of minds
Eric Topol: The wireless future of medicine
Philip K. Howard: Four ways to fix a broken legal system
Kevin Kelly: Technology's epic story
Bill Gates: Innovating to zero!
Aimee Mullins: The opportunity of adversity
David Cameron: The next age of government
Blaise Agüera y Arcas: Augmented-reality maps
Jamie Oliver: Teach every child about food
Peter Eigen: How to expose the corrupt
Tom Shannon, John Hockenberry: The painter and the pendulum
David Agus: A new strategy in the war on cancer
George Whitesides: A lab the size of a postage stamp
Jamie Heywood: The big idea my brother inspired
Sendhil Mullainathan: Solving social problems with a nudge
Derek Sivers: Weird, or just different?
Jane Chen: A warm embrace that saves lives
Eve Ensler: Embrace your inner girl
Joshua Prince-Ramus: Building a theater that remakes itself
Bill Davenhall: Your health depends on where you live
Anthony Atala: Growing new organs
Ravin Agrawal: 10 young Indian artists to watch
David Blaine: How I held my breath for 17 minutes
Charles Fleischer: All things are Moleeds
Lalitesh Katragadda: Making maps to fight disaster, build economies
Kiran Sethi: Kids, take charge
Kartick Satyanarayan: How we rescued the "dancing" bears"
Herbie Hancock: An all-star set
Romulus Whitaker: The real danger lurking in the water
Dan Buettner: How to live to be 100+
Nick Veasey: Exposing the invisible
Vilayanur Ramachandran: The neurons that shaped civilization
Bertrand Piccard: My solar-powered adventure
Asher Hasan: My message of peace from Pakistan
Steven  Cowley: Fusion is energy's future
Shaffi Mather: A new way to fight corruption
James Geary: Metaphorically speaking
Charles Anderson: Dragonflies that fly across oceans
Alexis Ohanian: How to make a splash in social media
Ryan Lobo: Photographing the hidden story
Loretta Napoleoni: The intricate economics of terrorism
Shereen El Feki: Pop culture in the Arab world
Thulasiraj Ravilla: How low-cost eye care can be world-class
Marc Pachter: The art of the interview
Rory  Bremner: A one-man world summit
Sunitha Krishnan: The fight against sex slavery
Scott Kim: The art of puzzles
Anupam Mishra: The ancient ingenuity of water harvesting
Andrea Ghez: The hunt for a supermassive black hole
Gordon Brown: Global ethic vs. national interest
Shashi Tharoor: Why nations should pursue soft power
Mallika Sarabhai: Dance to change the world
Magnus Larsson: Turning dunes into architecture
Rob Hopkins: Transition to a world without oil
Hans Rosling: Asia's rise -- how and when
Tom Wujec: Learn to use the 13th-century astrolabe
Devdutt Pattanaik: East vs. West -- the myths that mystify
Fields Wicker-Miurin: Learning from leadership's missing manual
Mathieu Lehanneur: Science-inspired design
Pranav Mistry: The thrilling potential of SixthSense technology
Cynthia Schneider: The surprising spread of Idol TV
Edward Burtynsky: Photographing the landscape of oil
Rachel Pike: The science behind a climate headline
Cameron Sinclair: The refugees of boom-and-bust
Stefana Broadbent: How the Internet enables intimacy
Marcus du Sautoy: Symmetry, reality's riddle
Becky  Blanton: The year I was homeless
Rachel Armstrong: Architecture that repairs itself?
David Deutsch: A new way to explain explanation
Ian Goldin: Navigating our global future
Marc Koska: 1.3m reasons to re-invent the syringe
Itay Talgam: Lead like the great conductors
Paul Debevec: Animating a photo-real digital face
John Gerzema: The post-crisis consumer
Julian Treasure: The 4 ways sound affects us
Henry Markram: A brain in a supercomputer
Rory Sutherland: Life lessons from an ad man
David Hanson: Robots that "show emotion"
Eric Sanderson: New York -- before the City
Sam Martin: Claim your "manspace"
Beau Lotto: Optical illusions show how we see
Chimamanda Ngozi Adichie: The danger of a single story
David Logan: Tribal leadership
Carolyn Steel: How food shapes our cities
Stefan Sagmeister: The power of time off
Garik Israelian: How spectroscopy could reveal alien life
Karen Armstrong: Let's revive the Golden Rule
Tim Brown: Designers -- think big!
Parag Khanna: Mapping the future of countries
Jacqueline Novogratz: A third way to think about aid
Taryn Simon: Photographs of secret sites
William Kamkwamba: How I harnessed the wind
Evgeny Morozov: How the Net aids dictatorships
Jonathan Zittrain: The Web as random acts of kindness
Imogen Heap: "Wait It Out"
Oliver Sacks: What hallucination reveals about our minds
John Lloyd: An inventory of the invisible
Bjarke Ingels: 3 warp-speed architecture tales
Misha Glenny: How global crime networks work
Rebecca Saxe: How we read each other's minds
Lewis Pugh: How I swam the North Pole
James Balog: Time-lapse proof of extreme ice loss
Steve Truglia: A leap from the edge of space
Evan Grant: Making sound visible through cymatics
Geoff Mulgan: Post-crash, investing in a better world
Joshua Silver: Adjustable liquid-filled eyeglasses
Cary Fowler: One seed at a time, protecting the future of food
Natasha Tsakos: A multimedia theatrical adventure
Hans Rosling: Let my dataset change your mindset
Eric Giler: A demo of wireless electricity
Dan Pink: The puzzle of motivation
Emmanuel Jal: The music of a war child
Janine Benyus: Biomimicry in action
Paul Romer: Why the world needs charter cities
Michael Pritchard: How to make filthy water drinkable
Willard Wigan: Hold your breath for micro-sculpture
Elaine Morgan: I believe we evolved from aquatic apes
Golan Levin: Art that looks back at you
Alain de Botton: A kinder, gentler philosophy of success
Gordon Brown: Wiring a web for global good
Nina Jablonski: Skin color is an illusion
Jim Fallon: Exploring the mind of a killer
Daniel Kraft: A better way to harvest bone marrow
Olafur Eliasson: Playing with space and light
Stewart Brand: 4 environmental 'heresies'
Kary Mullis: A next-gen cure for killer infections
Sophal Ear: Escaping the Khmer Rouge
Tom Wujec: 3 ways the brain creates meaning
Eames Demetrios: The design genius of Charles + Ray Eames
Daniel Libeskind: 17 words of architectural inspiration
Gever Tulley: Life lessons through tinkering
Arthur Benjamin: Teach statistics before calculus!
Ray Zahab: My trek to the South Pole
Katherine Fulton: You are the future of philanthropy
Paul Collier: New rules for rebuilding a broken nation
Philip Zimbardo: The psychology of time
Catherine Mohr: Surgery's past, present and robotic future
Diane Benscoter: How cults rewire the brain
Clay Shirky: How social media can make history
Jane Poynter: Life in Biosphere 2
Richard St. John: Success is a continuous journey
Robert Full: Learning from the gecko's tail
Nancy Etcoff: Happiness and its surprises
John La Grou: A plug for smart power outlets
Kevin Surace: Eco-friendly drywall
Pete Alcorn: The world in 2200
Felix Dennis: Odes to vice and consequences
Yann Arthus-Bertrand: A wide-angle view of fragile Earth
Ray Kurzweil: A university for the coming singularity
Liz Coleman: A call to reinvent liberal arts education
Kaki King: Playing "Pink Noise" on guitar
Jonathan Drori: Why we're storing billions of seeds
Jay Walker: The world's English mania
Michelle Obama: A plea for education
Joachim de Posada: Don't eat the marshmallow!
Yves Behar: A supercharged motorcycle design
Carolyn Porco: Could a Saturn moon harbor life?
Mary Roach: 10 things you didn't know about orgasm
Dan Ariely: Are we in control of our own decisions?
Ray Anderson: The business logic of sustainability
Naturally 7: A full-band beatbox
Nandan Nilekani: Ideas for India's future
Hans Rosling: Insights on HIV, in stunning data visuals
Seth Godin: The tribes we lead
Al Gore: What comes after An Inconvenient Truth?
Louise Fresco: We need to feed the whole world
Tom Shannon: Anti-gravity sculpture
Mae Jemison: Teach arts and sciences together
Sean Gourley: The mathematics of war
Brian Cox: What went wrong at the LHC
Laurie Garrett: Lessons from the 1918 flu
Sarah Jones: A one-woman global village
Michael Merzenich: Growing evidence of brain plasticity
Alex Tabarrok: How ideas trump crises
Ben Katchor: Comics of bygone New York
Erik Hersman: Reporting crisis via texting
Nate Silver: Does racism affect how you vote?
Niels Diffrient: Rethinking the way we sit down
Margaret Wertheim: The beautiful math of coral
Matthew Childs: 9 life lessons from rock climbing
Tim Ferriss: Smash fear, learn anything
JoAnn Kuchera-Morin: Stunning data visualization in the AlloSphere
Gregory Stock: To upgrade is human
Shai Agassi: A new ecosystem for electric cars
Renny Gleeson: Our antisocial phone tricks
Emily Levine: A theory of everything
Bonnie Bassler: How bacteria "talk"
Bruce Bueno de Mesquita: A prediction for the future of Iran
Nathaniel Kahn: Scenes from "My Architect"
P.W. Singer: Military robots and the future of war
Christopher C. Deam: The Airstream, restyled
Ueli Gegenschatz: Extreme wingsuit flying
Jacek Utko: Can design save newspapers?
C.K. Williams: Poetry of youth and age
Nathan Wolfe: The jungle search for viruses
John Wooden: The difference between winning and succeeding
David Pogue: Cool tricks your phone can do
Jacqueline Novogratz: An escape from poverty
Saul Griffith: High-altitude wind energy from kites!
Kamal Meattle: How to grow fresh air
Bruce McCall: What is retro-futurism?
Adam Savage: My obsession with objects and the stories they tell
Dan Ariely: Our buggy moral code
Dan Dennett: Cute, sexy, sweet, funny
Tim Berners-Lee: The next web
Stuart Brown: Play is more than just fun
Aimee Mullins: My 12 pairs of legs
Pattie Maes + Pranav Mistry: Meet the SixthSense interaction
Don Norman: 3 ways good design makes you happy
Mike Rowe: Learning from dirty jobs
Nalini Nadkarni: Conserving the canopy
Willie Smits: How to restore a rainforest
Brenda Laurel: Why not make video games for girls?
Evan Williams: The voices of Twitter users
Miru Kim: My underground art explorations
Richard Pyle: A dive into the reef's Twilight Zone
Charles Moore: Seas of plastic
Ed Ulbrich: How Benjamin Button got his face
Jill Tarter: Join the SETI search
Sylvia Earle: My wish: Protect our oceans
Gustavo Dudamel and the Teresa Carre√±o Youth Orchestra: El Sistema's top youth orchestra
Jose Antonio Abreu: The El Sistema music revolution
Juan Enriquez: The next species of human
Barry Schwartz: Our loss of wisdom
David Merrill: Toy tiles that talk to each other
Milton Glaser: Using design to make ideas new
Elizabeth Gilbert: Your elusive creative genius
Bill Gates: Mosquitos, malaria and education
Bill Gross: A solar energy system that tracks the sun
Natalie MacMaster: Fiddling in reel time
Joe DeRisi: Solving medical mysteries
Aimee Mullins: Changing my legs - and my mindset
Peter Ward: A theory of Earth's mass extinctions
Woody Norris: Hypersonic sound and other inventions
Sherwin Nuland: The extraordinary power of ordinary people
Barry Schuler: Genomics 101
Jamais Cascio: Tools for a better world
David Carson: Design and discovery
Paula Scher: Great design is serious, not solemn
Joseph Pine: What consumers want
Peter Reinhart: The art and craft of bread
Scott McCloud: The visual magic of comics
Rob Forbes: Ways of seeing
Greg Lynn: Organic algorithms in architecture
Paul Moller: My dream of a flying car
Paul Sereno: Digging up dinosaurs
John Maeda: My journey in design
Kary Mullis: Play! Experiment! Discover!
Jennifer 8. Lee: The hunt for General Tso
Nicholas Negroponte: Taking OLPC to Colombia
Steven Strogatz: The science of sync
Penelope Boston: There might just be life on Mars
Benjamin Wallace: The price of happiness
Dan Gilbert: Why we make bad decisions
Jay Walker: My library of human imagination
Dennis vanEngelsdorp: A plea for bees
Eva Zeisel: The playful search for beauty
David Holt: The joyful tradition of mountain music
Nick Sears: Demo: The Orb
Larry Burns: The future of cars
Philip Rosedale: Life in Second Life
Richard Preston: The mysterious lives of giant trees
Gregory Petsko: The coming neurological epidemic
Andy Hobsbawm: Do the green thing
Dan Barber: A foie gras parable
Bill Joy: What I'm worried about, what I'm excited about
George Smoot: The design of the universe
Franco Sacchi: A tour of Nollywood, Nigeria's booming film industry
Isaac Mizrahi: Fashion and creativity
Stewart Brand: The Long Now
Ursus Wehrli: Tidying up art
Charles Elachi: The story behind the Mars Rovers
Samantha Power: A complicated hero in the war on dictatorship
Lee Smolin: Science and democracy
Luca Turin: The science of scent
Tim Brown: Tales of creativity and play
John Francis: Walk the earth ... my 17-year vow of silence
James Surowiecki: The power and the danger of online crowds
Graham Hawkes: A flight through the ocean
Robert Wright: The evolution of compassion
Robert Thurman: Expanding your circle of compassion
Feisal Abdul Rauf: Lose your ego, find your compassion
James Forbes: Compassion at the dinner table
Dayananda Saraswati: The profound journey of compassion
Jackie Tabick: The balancing act of compassion
Newton Aduaka: The story of Ezra
Zach Kaplan + Keith Schacht: Toys and materials from the future
Rives: A story of mixed emoticons
Jared Diamond: Why do societies collapse?
Kristen Ashburn: The face of AIDS in Africa
Mihaly Csikszentmihalyi: Flow, the secret to happiness
Paul MacCready: Nature vs. humans
John Hodgman: Aliens, love -- where are they?
Dean Ornish: Healing through diet
Virginia Postrel: On glamour
Paola Antonelli: Design and the Elastic Mind
Garrett Lisi: An 8-dimensional model of the universe
James Burchfield: Playing invisible turntables
Steven Johnson: The Web as a city
Doris Kearns Goodwin: Lessons from past presidents
David Perry: Are games better than life?
James Nachtwey: Moving photos of extreme drug-resistant TB
Liz Diller: The Blur Building and other tech-empowered architecture
Noah Feldman: Politics and religion are technologies
Stefan Sagmeister: Designing with slogans
Rodney Brooks: Robots will invade our lives
Steven Pinker: Human nature and the blank slate
Caleb Chung: Playtime with Pleo, your robotic dinosaur friend
Laura Trice: Remember to say thank you
Philip Zimbardo: The psychology of evil
Marvin Minsky: Health and the human mind
David S. Rose: How to pitch to a VC
Eve Ensler: What security means to me
Jonathan Haidt: The moral roots of liberals and conservatives
Ann Cooper: What's wrong with school lunches
Keith Bellows: The camel's hump
Carmen Agra Deedy: Once upon a time, my mother ...
David Gallo: Life in the deep oceans
Brewster Kahle: A free digital library
Irwin Redlener: How to survive a nuclear attack
Jane Goodall: How humans and animals can live together
Jonathan Drori: What we think we know
Peter Hirshberg: The web is more than "better TV"
Peter Diamandis: Our next giant leap
Paul Rothemund: DNA folding, in detail
Einstein the Parrot: A talking, squawking parrot
Ory Okolloh: How I became an activist
Sugata Mitra: Kids can teach themselves
John Q. Walker: Great piano performances, recreated
Nellie McKay: "The Dog Song"
Ian Dunbar: Dog-friendly dog training
Lennart Green: Close-up card magic with a twist
David Griffin: How photography connects us
Spencer Wells: A family tree for humanity
Patricia Burchat: Shedding light on dark matter
Bruno Bowden + Rufus Cappadocia: Blindfold origami and cello
Robert Lang: The math and magic of origami
Kwabena Boahen: A computer that works like the brain
Kevin Kelly: The next 5,000 days of the web
Reed Kroloff: A tour of modern architecture
Jonathan Harris: The web as art
Louise Leakey: A dig for humanity's origins
Chris Abani: On humanity
Marisa Fick-Jordan: The wonder of Zulu wire art
Martin Seligman: The new era of positive psychology
Keith Barry: Brain magic
AJ Jacobs: My year of living biblically
Billy Graham: On technology and faith
Helen Fisher: The brain in love
Freeman Dyson: Let's look for life in the outer solar system
Nellie McKay: "Mother of Pearl," "If I Had You"
Clay Shirky: Institutions vs. collaboration
David Hoffman: What happens when you lose everything
Torsten Reil: Animate characters by evolving them
Corneille Ewango: A hero of the Congo forest
Raul Midon: "Peace on Earth"
Rick Smolan: The story of a girl
Peter Diamandis: Stephen Hawking's zero g flight
Nellie McKay: "Clonie"
Nicholas Negroponte: One Laptop per Child, two years on
Benjamin Zander: The transformative power of classical music
Steven Levitt: Surprising stats about child carseats
Adam Grosser: A mobile fridge for vaccines
Robert Full: Robots inspired by cockroach ingenuity
Dean Ornish: Your genes are not your fate
Chris Jordan: Turning powerful stats into art
George Dyson: The birth of the computer
Murray Gell-Mann: The ancestor of language
Wade Davis: The worldwide web of belief and ritual
Nathan Myhrvold: Archeology, animal photography, BBQ ...
Susan Blackmore: Memes and "temes"
Paul Collier: The "bottom billion"
Seyi Oyesola: A hospital tour in Nigeria
Arthur Ganson: Moving sculpture
Yves Behar: Designing objects that tell stories
Robert Ballard: The astonishing hidden world of the deep ocean
Mark Bittman: What's wrong with what we eat
Alisa Miller: How the news distorts our worldview
Joshua Klein: A thought experiment on the intelligence of crows
Michael Moschen: Juggling as art ... and science
Paul Ewald: Can we domesticate germs?
Paul Stamets: 6 ways mushrooms can save the world
Hector Ruiz: The thinking behind 50x15
They Might Be Giants: Wake up!
Brian Cox: CERN's supercollider
Brian Greene: Making sense of string theory
Amy Tan: Where does creativity hide?
Ernest Madu: World-class health care
Yochai Benkler: The new open-source economics
Tod Machover + Dan Ellsey: Inventing instruments that unlock new music
Johnny Lee: Free or cheap Wii Remote hacks
Al Gore: New thinking on the climate crisis
Stephen Hawking: Questioning the universe
Jakob Trollback: A new kind of music video
David Hoffman: Sputnik mania
Siegfried Woldhek: The search for the true face of Leonardo
Clifford Stoll: The call to learn
Christopher deCharms: A look inside the brain in real time
Norman Foster: My green agenda for architecture
Neil Turok: My wish: Find the next Einstein in Africa
Karen Armstrong: My wish: The Charter for Compassion
Dave Eggers: My wish: Once Upon a School
Frank Gehry: My days as a young rebel
Jill Bolte Taylor: My stroke of insight
Nicholas Negroponte: 5 predictions, from 1984
Craig Venter: On the verge of creating synthetic life
Alan Kay: A powerful idea about ideas
Roy Gould + Curtis Wong: A preview of the WorldWide Telescope
Steve Jurvetson: Model rocketry
Joseph Lekuton: A parable for Kenya
Raspyni Brothers: Juggle and jest
Jill Sobule + Julia Sweeney: The Jill and Julia Show
Moshe Safdie: Building uniqueness
George Dyson: The story of Project Orion
Pamelia Kurstin: The untouchable music of the theremin
Howard Rheingold: The new power of collaboration
Michael Pollan: A plant's-eye view
David Macaulay: An illustrated journey through Rome
Jaime Lerner: A song of the city
Robin Chase: The idea behind Zipcar (and what comes next)
Chris Anderson: TED's nonprofit transition
Alison Jackson: An unusual glimpse at celebrity
David Pogue: The music wars
Ben Dunlap: The life-long learner
Bill Strickland: Rebuilding a neighborhood with beauty, dignity, hope
Raul Midon: "Tembererana"
Frank Gehry: A master architect asks, Now what?
Paola Antonelli: Treat design as art
David Gallo: Underwater astonishments
J.J. Abrams: The mystery box
Deborah Gordon: The emergent genius of ant colonies
Yossi Vardi: We're worried about local warming ... in your lap
Isabel Allende: Tales of passion
Gever Tulley: 5 dangerous things you should let your kids do
Lakshmi Pratury: The lost art of letter-writing
Daniel Goleman: Why aren't we more compassionate?
Arthur Benjamin: A performance of "Mathemagic"
Amory Lovins: Winning the oil endgame
Murray Gell-Mann: Beauty, truth and ... physics?
Philippe Starck: Design and destiny
Ron Eglash: The fractals at the heart of African designs
Robert Full: The sticky wonder of gecko feet
Larry Brilliant: The case for optimism
Juan Enriquez: Using biology to rethink the energy challenge
David Keith: A critical look at geoengineering against climate change
Paul Rothemund: Playing with DNA that self-assembles
Lawrence Lessig: Laws that choke creativity
Matthieu Ricard: The habits of happiness
Sherwin Nuland: How electroshock therapy changed me
Eleni Gabre-Madhin: A commodities exchange for Ethiopia
VS Ramachandran: 3 clues to understanding your brain
Jan Chipchase: The anthropology of mobile phones
Maira Kalman: The illustrated woman
Hod Lipson: Building "self-aware" robots
Richard Branson: Life at 30,000 feet
Kenichi Ebina: My magic moves
Carolyn Porco: This is Saturn
Paul MacCready: A flight on solar wings
Stephen Petranek: 10 ways the world could end
John Maeda: Designing for simplicity
Zeresenay Alemseged: The search for humanity's roots
Deborah Scranton: An Iraq war movie crowd-sourced from soldiers
Steven Pinker: The surprising decline in violence
Steven Pinker: What our language habits reveal
Theo Jansen: My creations, a new form of life
Andrew Mwenda: Aid for Africa? No thanks.
Erin McKean: The joy of lexicography
Dean Kamen: Luke, a new prosthetic arm for soldiers
Jeff Skoll: My journey into movies that matter
Vusi Mahlasela: "Thula Mama"
Jacqueline Novogratz: Patient capitalism
Chris Abani: Telling stories from Africa
Patrick Awuah: How to educate leaders? Liberal arts
Euvin Naidoo: Why invest in Africa
William Kamkwamba: How I built a windmill
Ngozi Okonjo-Iweala: Aid versus trade
George Ayittey: Africa's cheetahs versus hippos
Allison Hunt: How to get (a new) hip
David Bolinsky: Visualizing the wonder of a living cell
Rives: The  4 a.m. mystery
Will Wright: Spore, birth of a game
Emily Oster: Flip your thinking on AIDS in Africa
Jonathan Harris: The Web's secret stories
Alan Russell: The potential of regenerative medicine
Dan Dennett: Dangerous memes
Bill Stone: I'm going to the moon. Who's with me?
Hans Rosling: New insights on poverty
Stephen Lawler: Tour Microsoft's Virtual Earth
Thomas Barnett: Let's rethink America's military strategy
David Rockwell: A memorial at Ground Zero
Robert Thurman: We can be Buddhas
Anand Agarawala: Rethink the desktop with BumpTop
Ngozi Okonjo-Iweala: Want to help Africa? Do business here
John Doerr: Salvation (and profit) in greentech
Blaise Agüera y Arcas: How PhotoSynth can connect the world's images
Tierney Thys: Swim with the giant sunfish
Jeff Hawkins: How brain science will change computing
Stewart Brand: What squatter cities can teach us
David Kelley: Human-centered design
James Howard Kunstler: The ghastly tragedy of the suburbs
Stew: "Black Men Ski"
Sergey Brin + Larry Page: The genesis of Google
Natalie MacMaster: Cape Breton fiddling in reel time
Chris Anderson: Technology's long tail
Rachelle Garniez: "La Vie en Rose"
Tom Rielly: A comic sendup of TED2006
Richard Dawkins: Militant atheism
Tom Honey: Why would God create a tsunami?
Eddi Reader: "Kiteflyer's Hill"
Eddi Reader: "What You've Got"
Rives: A mockingbird remix of TED2006
Jeff Bezos: The electricity metaphor for the web's future
William McDonough: Cradle to cradle design
Evelyn Glennie: How to truly listen
Dan Dennett: The illusion of consciousness
Caroline Lavelle: Casting a spell on the cello
Jill Sobule: Global warming's theme song, "Manhattan in January"
Jane Goodall: What separates us from chimpanzees?
Seth Godin: How to get your ideas to spread
James Watson: How we discovered DNA
Al Seckel: Visual illusions that show how we (mis)think
Dean Kamen: To invent is to give
Juan Enriquez: The life code that will reshape the future
Stefan Sagmeister: Happiness by design
Alex Steffen: The route to a sustainable future
Thom Mayne: How architecture can connect us
Chris Bangle: Great cars are great art
Nora York: Singing "What I Want"
Paul Bennett: Design is in the details
Vik Muniz: Art with wire, sugar, chocolate and string
Nick Bostrom: A philosophical quest for our biggest problems
Janine Benyus: Biomimicry's surprising lessons from nature's engineers
Craig Venter: Sampling the ocean's DNA
Golan Levin: Software (as) art
Susan Savage-Rumbaugh: The gentle genius of bonobos
Frans Lanting: The story of life in photographs
Sheila Patek: The shrimp with a kick!
Bill Clinton: My wish: Rebuilding Rwanda
E.O. Wilson: My wish: Build the Encyclopedia of Life
James Nachtwey: My wish: Let my photographs bear witness
Carl Honoré: In praise of slowness
Saul Griffith: Everyday inventions
Neil Gershenfeld: Unleash your creativity in a Fab Lab
Anna Deavere Smith: Four American characters
Steven Johnson: How the "ghost map" helped end a killer disease
Charles Leadbeater: The era of open innovation
Martin Rees: Is this our final century?
Robert Wright: Progress is not a zero-sum game
Wade Davis: Dreams from endangered cultures
Phil Borges: Photos of endangered cultures
Robert Neuwirth: The hidden world of shadow cities
Bjorn Lomborg: Global priorities bigger than climate change
Richard St. John: 8 secrets of success
Rives: If I controlled the Internet
Dean Ornish: The killer American diet that's sweeping the planet
Peter Gabriel: Fight injustice with raw video
Kevin Kelly: How technology evolves
Ray Kurzweil: The accelerating power of technology
Peter Donnelly: How juries are fooled by statistics
Michael Shermer: Why people believe weird things
Bono: My wish: Three actions for Africa
Edward Burtynsky: My wish: Manufactured landscapes and green education
Robert Fischell: My wish: Three unusual medical inventions
Burt Rutan: The real future of space exploration
Ben Saunders: Why did I ski to the North Pole?
Sasa Vucinic: Why we should invest in a free press
Ashraf Ghani: How to rebuild a broken state
Iqbal Quadir: How mobile phones can fight poverty
Jacqueline Novogratz: Invest in Africa's own solutions
Eva Vertes: Meet the future of cancer research
Aubrey de Grey: A roadmap to end aging
Dan Gilbert: The surprising science of happiness
Barry Schwartz: The paradox of choice
Steven Levitt: The freakonomics of crack dealing
Malcolm Gladwell: Choice, happiness and spaghetti sauce
David Deutsch: Chemical scum that dream of distant quasars
Richard Dawkins: Why the universe seems so strange
Helen Fisher: Why we love, why we cheat
Eve Ensler: Happiness in body and soul
Ze Frank: Nerdcore comedy
Mena Trott: Meet the founder of the blog revolution
Jimmy Wales: The birth of Wikipedia
Richard Baraniuk: The birth of the open-source learning revolution
Amy Smith: Simple designs to save a life
Ross Lovegrove: Organic design, inspired by nature
Sirena Huang: An 11-year-old's magical violin
Jennifer Lin: Improvising on piano, aged 14
Jeff Han: The radical promise of the multi-touch interface
Nicholas Negroponte: One Laptop per Child
Cameron Sinclair: My wish: A call for open-source architecture
Jehane Noujaim: My wish: A global day of film
Larry Brilliant: My wish: Help me stop pandemics
Dan Dennett: Let's teach religion -- all religion -- in schools
Rick Warren: A life of purpose
Julia Sweeney: Letting go of God
Joshua Prince-Ramus: Behind the design of Seattle's library
Hans Rosling: The best stats you've ever seen
Tony Robbins: Why we do what we do
Ken Robinson: Do schools kill creativity?
Al Gore: Averting the climate crisis
David Pogue: Simplicity sells
Majora Carter: Greening the ghetto
